3d|William Govan|China|Jungler
A|Frank Dedrick|Mexico|Mid
A1|Larry Alexander|Macao|Mid
Aa|Ana Teano|Lithuania|Jungler
Aaberg|Karan Walker|Denmark|Mid
Aachen|Ronald Goza|Poland|AD
Aalborg|Elizabeth Narro|Armenia|Support
Aalesund|Gregg Moser|Malta|Mid
Aalii|Russell Davis|Chile|AD
Aalst|Milagros Covington|Japan|Mid
Aalto|Megan Poblete|Ukraine|Sub
Aam|Tracy Proctor|Colombia|Top
Aara|Misty Kidwell|Italy|Mid
Aarau|Leroy Tolbert|Afghanistan|Mid
Aardvark|Candace Dugan|Russia|Sub
Aardwolf|Phyllis Luera|South Korea|Support
Aaren|Steve Smith|Indoensia|Jungler
Aargau|Isabella Philo|Turkey|Support
Aarhus|Lena Bedolla|Germany|Jungler
Aarika|Teresa Devine|South Korea|Support
Aaronaaronic|Emilio Mcwayne|Luxembourg|Support
Aaronson|Katherine Toure|Serbia|Sub
Ab|David Hill|Macao|Sub
Aba|Gerard Warren|Macao|AD
Abaca|Troy Salyers|South Africa|Mid
Abacist|Mickey Phillips|South Korea|Support
Aback|Joanna Hanson|Kazakhstan|Support
Abacus|Richard Johnson|United States|AD
Abad|Crystal Macdonald|Ecuador|Top
Abadan|David Landry|Estonia|Jungler
Abaddon|Glenda Rodriguez|Germany|AD
Abaft|Max Smith|Netherlands|Top
Abagael|Shirley Griffin|Italy|Top
Abagail|Robert Fontenot|Croatia|AD
Abalone|Morris Hubley|France|Mid
Abamp|John Stevens|Mexico|Mid
Abampere|James Fagan|United States|Sub
Abana|Martin Smith|Kazakhstan|Jungler
Abandon|Jill Sammon|Colombia|Jungler
Abandoned|Margaret Hutchens|Turkey|Sub
Abarca|Leroy Evans|Panama|Mid
Abase|Jonathan Cisneros|Lithuania|Support
Abash|Maria Adams|Malta|Sub
Abate|Joe Lee|China|Sub
Abatement|Joshua Brown|Iraq|AD
Abatis|Teri Michael|Afghanistan|Top
Abattoir|Barbara Mcgrath|China|Top
Abaxial|Catherine Moser|Afghanistan|Mid
Abb|Monica Boyd|Ukraine|Jungler
Abba|Maria Sims|Norway|Support
Abbacy|Matthew Jacobsma|Turkey|Sub
Abbasid|Harry Jalbert|Iceland|Top
Abbate|Cassandra Etter|Thailand|Sub
Abbatial|Scott Rogers|Hong Kong|Jungler
Abbe|Katherine Barron|Sweden|Top
Abbess|Peter Walker|Japan|Support
Abbevillian|James Williams|Russia|Mid
Abbey|Matthew Mayfield|Singapore|Jungler
Abbeyabbi|Tillie Ruiz|Kazakhstan|Support
Abbie|Paul Weaver|Germany|Sub
Abbieabbot|William Franklin|Israel|Sub
Abbotsen|Opal Danahy|France|Top
Abbotson|James Turner|Luxembourg|Sub
Abbotsun|Priscilla Mitchell|Macao|Mid
Abbott|Tommy Sierra|Ecuador|Mid
Abbottson|Debra Ward|Argentina|Jungler
Abbreviate|Nita Marlowe|Turkey|AD
Abbreviated|Nicholas Gordillo|Sweden|Sub
Abbreviation|Yolanda Anderson|Norway|AD
Abby|Nathaniel Bradney|Poland|Top
Abbyabbye|Richard Cook|Mexico|Jungler
Abc|George Pabon|Denmark|Support
Abcoulomb|Nguyet Pham|Kazakhstan|Mid
Abdel|Jaime Greenwood|Kazakhstan|Support
Abdella|Judy Singer|Hong Kong|Mid
Abdias|Joseph Parker|Norway|Mid
Abdicate|James Cardenas|South Korea|Mid
Abdication|Celesta Swilley|Malta|Sub
Abdomen|James Hodges|Italy|AD
Abdominal|Gale Vanbrunt|United States|AD
Abdominous|Geneva Nunley|Israel|Top
Abdu|Jessica Gonzalez|Indoensia|AD
Abduce|Rodolfo Nipp|Japan|Sub
Abducent|David Handy|Czech Republic|Support
Abduct|Teresa Boesen|Israel|Sub
Abduction|Liane Tiffany|Macao|AD
Abductor|Kenneth Lewis|Vietnam|AD
Abdul|Melissa Garcia|Slovenia|Sub
Abdulabdulla|Charles Gilbert|United States|Top
Abdullah|Denise Williams|Slovenia|Mid
Abe|Brian Martin|Hungary|Sub
Abeabeam|Richard Hayes|France|Jungler
Abebi|Percy Goffinet|Turkey|Sub
Abecedarian|Salvador Harrison|Chile|AD
Abecedarium|Felix Rutherford|Argentina|AD
Abecedary|Fernando Shoemake|United States|Top
Abed|Laurie Daly|Ecuador|Mid
Abednego|Mattie Colanero|Netherlands|AD
Abel|Brandi Duron|Chile|Sub
Abelabelard|Eric Lamberton|Australia|Sub
Abele|Robert Hutton|Argentina|Sub
Abell|Daniel Lundberg|Macao|Mid
Abelmosk|Stanley Cordova|Russia|AD
Abeokuta|Nicole Okwuona|Indoensia|Mid
Abercrombie|Hazel Singer|Iceland|AD
Abercromby|William Irwin|Macao|Sub
Aberdare|Douglas Fiala|South Africa|Support
Aberdeen|Joseph Johansen|Australia|AD
Abernathy|Paula Wagoner|Spain|Top
Abernethy|Dan Cruz|Greece|Top
Abernon|Gloria Sargent|Ecuador|Top
Aberrant|Bruce Figueroa|Spain|Mid
Aberration|August Fadden|Peru|Mid
Abert|Richard Chandler|Macao|Sub
Abessive|Gerry Mccalla|Slovenia|Jungler
Abet|Gary Green|Argentina|Jungler
Abettor|Kevin Davies|Peru|Top
Abeu|Eleanor Grant|Chile|Sub
Abey|David Gentile|Belgium|Mid
Abeyance|Angela Saxton|Iraq|AD
Abeyant|Cindy Warner|Armenia|Jungler
Abeyta|Derrick Wheeler|Malta|AD
Abfarad|Patricia Bain|Kazakhstan|AD
Abhenry|Lydia Bateman|South Africa|Jungler
Abhor|Gary Buziak|Costa Rica|Jungler
Abhorrence|Cecelia Brown|Spain|AD
Abhorrent|George Green|United Kingdom|Support
Abib|Boyd Wade|Japan|AD
Abide|Robert Duckett|Czech Republic|Support
Abiding|Thomas Wilson|Czech Republic|Jungler
Abidjan|Joseph Wicker|Hungary|Support
Abie|Robert Chueng|Chile|AD
Abigael|Crystal Eichler|Malta|Support
Abigail|Ashley Sin|Iceland|Sub
Abigailabigale|William Murray|Sweden|Support
Abijah|Walter Hoover|Hong Kong|Mid
Abilene|Kenneth Fitzgerald|Sweden|Mid
Ability|Jewel Martin|Lithuania|Jungler
Abingdon|Kathy Austin|Kazakhstan|Top
Abiogenesis|Melvin Maltie|Israel|Sub
Abiogenetic|Phillip Oneal|Russia|Mid
Abiosis|Steven Espinoza|Iceland|AD
Abiotic|Dewayne Mynatt|Macao|Support
Abirritant|Nicholas Leavens|Singapore|Support
Abirritate|Timothy Burks|Slovenia|Mid
Abisha|Donald Riles|Germany|Jungler
Abisia|Maria Harney|Greece|Support
Abixah|Ronald Fleming|Spain|AD
Abject|Lori Boyd|United Kingdom|Support
Abjuration|Linda Cooper|Germany|Jungler
Abjure|Jacob Winkler|France|Sub
Ablate|Travis Washing|Germany|Sub
Ablation|Ana Phillips|Israel|Support
Ablative|Sarah Robinson|Armenia|Sub
Ablaut|Joelle Scrivner|Lithuania|Jungler
Ablaze|Gerald Esquer|Hong Kong|Mid
Able|Pamela Cockrell|Poland|Top
Ablebodied|Sharon Hyre|South Africa|Support
Ablepsia|Ruby Heron|Sweden|Mid
Ables|Jack Zuniga|Hong Kong|AD
Abloom|Ada Cacciotti|Hungary|Top
Ablution|Jessica Dergance|Czech Republic|Support
Ably|Helen Cannon|Ukraine|AD
Abm|Cassandra Baker|Malta|Support
Abmho|Marvin Thomas|Luxembourg|Support
Abnaki|Martin Kluck|Finland|Jungler
Abnegate|Roger Roy|South Korea|Support
Abner|Betty Wessner|Indoensia|Mid
Abney|John Thomas|Australia|Mid
Abnormal|John Houston|Hong Kong|Sub
Abnormality|Kelly Ferry|Hong Kong|Jungler
Abnormity|Christian Mckenna|Armenia|Mid
Aboard|Jeffrey Hernandez|Mexico|AD
Abode|Elvin Richards|Ukraine|Mid
Abohm|Matthew Orellana|Philippines|Top
Abolish|Wallace Turman|Philippines|AD
Abolition|Daniel Bushman|Portugal|AD
Abomasum|Krystal Chaney|Italy|Mid
Abomb|Jose Harr|Luxembourg|Sub
Abominable|Dena Dolce|Taiwan|Top
Abominate|Claudia Mcintyre|Afghanistan|Support
Abomination|Anthony Schulte|Malta|Top
Aboral|Dorothy Malinowski|Costa Rica|Support
Aboriginal|Janice Hoover|Netherlands|Jungler
Aborigine|Stephen Olson|Philippines|Jungler
Aborn|Lexie Smith|Russia|Sub
Aborning|Scott West|Indoensia|Top
Abort|Sheryl Young|Philippines|Support
Aborticide|Hazel Floyd|Canada|Jungler
Abortifacient|Pandora Patterson|Iceland|AD
Abortion|Robert Torres|Belgium|Mid
Abortionist|Elizabeth Forman|Panama|AD
Abortive|Alma Mcculloch|Iceland|Top
Abott|Richard Blatz|Hong Kong|Jungler
Aboulia|Edward Flowers|Italy|Sub
Abound|Jordan Sowers|Italy|Mid
About|Paul Bruning|Indoensia|Top
Aboutface|Salome Frenzel|Israel|Top
Aboutship|Elizabeth Huskey|Macao|Support
Above|Candy Brown|Philippines|Support
Aboveboard|Cynthia Cotton|Spain|Mid
Aboveground|Kathryn Cuevas|Italy|Sub
Abra|David Bryant|United Kingdom|Top
Abracadabra|Edward Smith|Russia|AD
Abradant|Karen Mckeller|Kazakhstan|Sub
Abrade|Lance Green|Slovenia|AD
Abraham|William Pierson|Indoensia|Sub
Abrahamabrahams|Beverly Dunn|Spain|Top
Abrahamsen|Kevin Mcneely|Denmark|AD
Abrahan|Janet Coburn|Turkey|AD
Abram|Alvin Wirtz|France|Support
Abramabramo|Bobbie Pollina|Malta|Support
Abrams|Kathie Rudisill|Macao|Mid
Abramson|Israel Hesson|Malta|Sub
Abran|Anthony Palmer|Ukraine|AD
Abranchiate|Yvette Xiong|Italy|Support
Abrasion|Jeffery Edell|Italy|AD
Abrasive|James Hofmeister|Thailand|Jungler
Abraxas|William Wren|Taiwan|Support
Abreact|Paul Angelico|Argentina|Support
Abreaction|Richard Honig|Hong Kong|Mid
Abreast|Linda Placko|China|Jungler
Abrego|April Demelis|Spain|Jungler
Abreu|Martha Elliott|Taiwan|Jungler
Abri|Hazel Rieves|Germany|Sub
Abridge|Bobby Bryson|Italy|Sub
Abridgment|Tim Mantel|Indoensia|Mid
Abroach|Tina Husseini|Greece|Sub
Abroad|Jorge Lederer|Malta|Sub
Abrogate|Miranda Stclair|China|Sub
Abroms|Juanita Crowley|Italy|AD
Abrupt|Rose Raschke|Vietnam|AD
Abruption|Michael Leslie|Serbia|Jungler
Abruzzi|Robert Fleming|United Kingdom|Sub
Absa|Samuel Horn|South Africa|Support
Absalom|Elina Moss|United Kingdom|Support
Abscess|Jeff Cowen|Hungary|Jungler
Abscind|Frederick Heller|Kazakhstan|Mid
Abscise|William Ladner|Kazakhstan|AD
Abscissa|Jennifer Perez|Afghanistan|Support
Abscission|Connie Bickmore|United Kingdom|Sub
Abscond|Jeffery Staggs|Philippines|Sub
Abseil|Thelma Covert|Costa Rica|Jungler
Absence|Thelma Sutton|Peru|Sub
Absent|Karen Albertson|Brazil|Sub
Absentee|Eric Sanders|Ecuador|AD
Absenteeism|Morgan Garza|Slovenia|Jungler
Absently|David Johnson|Sweden|Top
Absentminded|Fred Peel|Germany|Top
Absher|Russell Washington|Kazakhstan|Support
Abshier|Robert Riis|Belgium|Jungler
Abshire|Pamela Griggs|Singapore|Mid
Absinthe|Craig Cardenas|Greece|Mid
Absinthism|Essie Dickerson|France|Jungler
Absolute|Gertie Jordan|Turkey|Top
Absolutely|Thomas Alexander|Ecuador|Sub
Absolution|Heidi Members|France|Top
Absolutism|Alice Chavez|Ecuador|Support
Absolve|William Bader|Chile|Top
Absonant|Stanley Coronado|Armenia|AD
Absorb|Myrtle Miller|Norway|Top
Absorbance|Mark Miller|South Africa|Top
Absorbed|Tena Kirwan|Hungary|Jungler
Absorbefacient|Maria Crass|Norway|AD
Absorbent|Deborah Mccoy|Armenia|Mid
Absorber|Laurie Mcnair|Costa Rica|Top
Absorbing|Elizabeth Smith|South Korea|AD
Absorptance|Thomas Blalock|Iceland|Sub
Absorption|Lisette Howard|Ecuador|Top
Absorptivity|Marina Toledo|United Kingdom|Jungler
Absquatulate|Irene Ramos|Japan|Jungler
Abstain|Betty Esquerra|Peru|Mid
Abstemious|Miguel Lavergne|Taiwan|Top
Abstention|Lamar Perry|Croatia|Support
Abstergent|Wayne Becknell|Colombia|Top
Abstinence|Gene Mann|Chile|Sub
Abstract|Leeann Duke|Italy|Top
Abstracted|Elizabeth Spearman|Turkey|AD
Abstraction|Alex Wilbur|Lithuania|Sub
Abstractionism|Martha Rolen|Afghanistan|Sub
Abstractionist|John Lora|Russia|Support
Abstriction|Jose Nasuti|Sweden|Mid
Abstruse|James Rustrian|Czech Republic|Sub
Absurd|Lorrie Hannaford|Singapore|Top
Absurdity|Elaine Adams|Armenia|Mid
Abubekr|Thomas Holloway|Norway|Support
Abukir|Diane Foster|Ecuador|Jungler
Abulia|Scotty Dressler|Netherlands|Mid
Abundance|Lamar Richardson|Estonia|Support
Abundant|Annie Dobson|Denmark|AD
Abuse|Marla Fletcher|Macao|Top
Abusive|Allison Melton|Greece|Support
Abut|Rita Rowell|Lithuania|Mid
Abutilon|Willie Beltran|Panama|Mid
Abutment|Michael Hubbard|Finland|Sub
Abuttal|Jim Edmonds|Belgium|Sub
Abuttals|Jean Kher|Brazil|Sub
Abutter|Christine Webb|Norway|Support
Abutting|Derek Baker|United Kingdom|Support
Abuzz|Sheila May|Estonia|Sub
Abvolt|Edward Dean|Philippines|Top
Abwatt|Tamiko Harris|Sweden|Mid
Aby|Angel Ernst|Malta|AD
Abydos|Amado Lovato|South Africa|Mid
Abysm|Rusty Spencer|Colombia|AD
Abysmal|David Phillips|France|Support
Abyss|Stephen Cummings|Belgium|Jungler
Abyssal|Tracy Brady|Norway|Top
Abyssinia|Kimberly Partain|Iceland|Jungler
Ac|Andrew Mendoza|Israel|Sub
Acacia|Yvette Pippenger|Colombia|Mid
Academe|Gary Michel|Chile|Mid
Academia|Armando Truman|Luxembourg|Top
Academic|Donovan Gilliam|Singapore|Jungler
Academician|Theresa Wolfe|Panama|Top
Academicism|Grady Ranck|Taiwan|Support
Academy|Robin Solt|Spain|Support
Acadia|Joy Lassiter|France|AD
Acadian|Mark Owens|United States|Jungler
Acaleph|Brenda Christensen|Costa Rica|Jungler
Acalia|Patricia Jacobson|Hungary|Support
Acanthaceous|Lisa Russell|Argentina|Sub
Acantho|Richard Winkle|France|Mid
Acanthocephalan|Louis Metz|Spain|Top
Acanthoid|Jacob Gaston|Russia|Mid
Acanthopterygian|Ida Brown|United Kingdom|AD
Acanthous|Jorge Eckard|Argentina|Sub
Acanthus|Vivian Gonzales|Italy|Jungler
Acapulco|Michael Durham|Slovenia|Jungler
Acariasis|Joseph Williford|Philippines|Sub
Acaricide|Juanita Kelly|Armenia|Mid
Acarid|Kenneth Nagy|Germany|Mid
Acaroid|Salvatore Davis|Kazakhstan|AD
Acarology|Thomas Ness|Italy|Mid
Acarpous|Benjamin Cecil|Kazakhstan|AD
Acarus|Randall Rinck|Afghanistan|Sub
Acatalectic|Charlene Montijo|Sweden|Jungler
Acaudal|Brenda Decker|Afghanistan|Mid
Acaulescent|Bruce Hairston|Israel|Support
Accad|Sharon Ingram|Indoensia|AD
Accalia|Karen Hughes|Thailand|AD
Accede|Mary Kittel|China|Sub
Accelerando|Sabrina Patino|Japan|AD
Accelerant|Stephen Dials|Hong Kong|Mid
Accelerate|Pat Lewis|Netherlands|AD
Acceleration|Kim Hyde|Thailand|Jungler
Accelerator|Ashley Reardon|Thailand|Sub
Accelerometer|Mabel Corkill|Peru|Jungler
Accent|Shawn Faust|Estonia|Jungler
Accentor|Elizabeth Stevens|Singapore|Sub
Accentual|Kristy Owens|Italy|Support
Accentuate|Juanita Hoisington|Russia|Mid
Accentuation|Mike Phillips|Sweden|AD
Accept|Heather Daisy|Ukraine|Sub
Acceptable|Barbara Paul|Armenia|Support
Acceptance|Tom Snider|Norway|Jungler
Acceptant|Jose Chandler|Hong Kong|AD
Acceptation|Alexis Conrad|Afghanistan|AD
Accepted|Roger Crowley|Kazakhstan|Mid
Accepter|Mario Armitage|Portugal|Top
Acceptor|Cathy Franks|Chile|Jungler
Access|Todd Robinson|Hungary|Sub
Accessary|Evelyn Bouldin|Afghanistan|Top
Accessible|Grace Little|Italy|Mid
Accession|Crystal Ranney|Australia|Support
Accessory|Shannon Banks|Czech Republic|AD
Acciaccatura|Andy Borek|Hong Kong|Support
Accidence|Shana Regan|Greece|Sub
Accident|James Brennan|Italy|AD
Accidental|Adell Crowe|Kazakhstan|Top
Accidie|Mary Morgan|Thailand|Sub
Accipiter|Stella Correia|Australia|Sub
Accipitrine|Manuel Dover|Czech Republic|Sub
Acclaim|Margie Green|South Korea|Top
Acclamation|Julie Tunson|Finland|Top
Acclimate|Johnnie Dull|Mexico|Sub
Acclimatize|Stephanie Bridgers|United States|AD
Acclivity|Lisa Griffen|Thailand|AD
Accolade|Nicholas Berger|Lithuania|AD
Accommodate|Jenny Hoopes|South Africa|Support
Accommodating|Julie Borden|Netherlands|Jungler
Accommodation|Coleman Cribbin|Israel|Sub
Accommodative|Anthony Sykes|Finland|AD
Accompaniment|Donald Sanders|Israel|Mid
Accompanist|Louise Clark|Spain|Support
Accompany|Patricia Henderson|United States|Sub
Accompanyist|Daniel Miller|Belgium|Jungler
Accomplice|Mark Bailey|South Africa|Top
Accomplish|Yi Wilford|Estonia|Top
Accomplished|Stephen Conteh|Portugal|AD
Accomplishment|Paul Andrews|Turkey|Sub
Accord|Lewis Adams|Afghanistan|AD
Accordance|Melody Ray|China|Top
Accordant|Frederick Anderson|Costa Rica|Jungler
According|Dennis Cleveland|Singapore|Sub
Accordingly|Marsha Brown|Greece|Sub
Accordion|Fred Williams|Colombia|Sub
Accost|Amanda Clifford|Portugal|Support
Accouchement|Beverly Harper|Singapore|Jungler
Accoucheur|Leila Joseph|South Africa|Top
Account|Christopher Lovett|Slovenia|Jungler
Accountable|Brenda Rainer|United States|Jungler
Accountancy|Vincent Evans|Thailand|Mid
Accountant|Linda Kennedy|Spain|Jungler
Accounting|Dianne Munguia|Lithuania|Jungler
Accouplement|Jose Sinstack|Hungary|Top
Accouter|Daisy Britton|Peru|Mid
Accouterment|Glenn Stolz|Netherlands|AD
Accoutre|Ariana Fulmore|Chile|Support
Accra|Maureen Starnes|Belgium|Top
Accredit|Sallie Cotton|China|Jungler
Accrescent|Wayne Sharp|Taiwan|Top
Accrete|Jeanette Wester|Norway|Sub
Accretion|Ralph Hernandez|Iraq|Mid
Accroach|Mary Ennis|Panama|Jungler
Accrual|Charles Rich|Malta|Mid
Accrue|Calvin Reyes|Hong Kong|Support
Acculturate|Delores Johnson|South Africa|Support
Acculturation|Carol Anderson|Belgium|AD
Acculturize|Stephen Miller|Singapore|Sub
Accumbent|Regina Tyree|Netherlands|Support
Accumulate|Renee Camacho|Kazakhstan|Sub
Accumulation|Lawrence Albrecht|Afghanistan|Jungler
Accumulative|Betty Johnson|China|Support
Accumulator|Earl Cowles|Taiwan|Mid
Accuracy|Ramon Cooney|Greece|Top
Accurate|Sophia Cassidy|Mexico|Support
Accursed|Marcus Marenco|Australia|Top
Accusal|Calvin Fitzsimmons|Costa Rica|Support
Accusation|Scott Whisenant|Australia|Mid
Accusative|Allan Nelson|France|AD
Accusatorial|Georgina Cuevas|Finland|Top
Accusatory|Natalie Garcia|Colombia|AD
Accuse|Brain Crawley|Luxembourg|Jungler
Accused|Elena Rodriguez|Armenia|Top
Accustom|Delbert Berry|Thailand|Support
Accustomed|Angela Gavin|Colombia|Sub
Ace|Jonathan Bolstad|Philippines|Support
Acea|Margaret Taylor|Poland|Support
Aceae|Marc Gabriel|Netherlands|Support
Acedia|Amanda Valentine|Finland|Mid
Aceldama|Victor Thornton|Brazil|Jungler
Acentric|Paul Bell|Japan|Support
Aceous|George Young|Thailand|Support
Acephalous|Anthony Perkins|Russia|AD
Acerate|Joseph Mims|Costa Rica|AD
Acerb|Danny Chene|Sweden|Top
Acerbate|Norma Lenning|Netherlands|AD
Acerbic|Lindsey Mcmullin|United States|Support
Acerbity|Joseph Mitchell|France|Mid
Acerose|John Mcbride|Iceland|AD
Acervate|John Dombroski|China|Mid
Acescent|Richard Walls|Croatia|AD
Acetabulum|Donna Donaldson|Australia|AD
Acetal|Sabra Martell|Hong Kong|Support
Acetaldehyde|Donald Lavin|Denmark|Jungler
Acetamide|Pam Mccloud|Argentina|Mid
Acetanilide|Jason Hodges|Ecuador|Sub
Acetate|James Alvarez|Mexico|Sub
Acetic|Gerard Marks|Czech Republic|Support
Acetify|Kathleen Jacobson|Kazakhstan|AD
Aceto|Betty Holt|Finland|Jungler
Acetometer|Robert Richardson|Indoensia|AD
Acetone|Cheryl Geary|Sweden|AD
Acetophenetidin|Sheila White|Slovenia|Top
Acetous|Matt Hanson|Malta|Sub
Acetum|Constance Bush|Sweden|Support
Acetyl|Connie Neal|Iraq|Mid
Acetylate|Cheryl White|Estonia|Jungler
Acetylcholine|Mark Lundeen|Canada|Support
Acetylene|Horace Boston|Kazakhstan|Support
Acetylide|James Culbreth|Malta|Sub
Acevedo|Robert America|Lithuania|Support
Aceves|Dustin Linton|Peru|Jungler
Acey|Dianna Currier|Italy|Support
Aceydeucy|Helen Loftis|Finland|AD
Achaea|Judy Smith|South Korea|AD
Achaean|Florence Moody|Sweden|AD
Achaemenid|Thomas Wine|Hungary|Top
Achates|Robert Gafford|Australia|Sub
Ache|Brittany Mitchem|Macao|Top
Achelous|Dylan Lemay|Sweden|Top
Achene|David Sisco|Chile|Top
Acherman|Susan Rodriguez|Serbia|Sub
Achernar|Arthur Lloyd|Italy|Mid
Acheron|William Williams|Japan|Mid
Achieve|Katrina Durst|Croatia|AD
Achievement|Karen Talamantes|Ukraine|Support
Achilles|Micheal Pettigrew|Panama|Support
Achitophel|Lila Binder|Luxembourg|AD
Achlamydeous|Elizabeth Marietta|Turkey|Top
Achlorhydria|Cathey Flores|Iraq|Mid
Achondrite|Brandon Dinwiddie|Luxembourg|Sub
Achondroplasia|Irma Twogood|Macao|Jungler
Achorn|Edward Kaplan|Estonia|AD
Achromat|Ronald Warren|Estonia|Support
Achromatic|Henry Nix|Costa Rica|Sub
Achromaticity|James Thedford|Taiwan|Mid
Achromatin|Dorothy Semien|Russia|Sub
Achromatism|Monica Momeni|Afghanistan|Jungler
Achromatize|Dell Wood|Philippines|Support
Achromatous|Samuel Tanner|Greece|AD
Achromic|Richard Mcgonagle|Armenia|Support
Acicula|Floyd Conway|Greece|AD
Acicular|Brett Alessio|Serbia|AD
Aciculate|Barbara Johnson|South Africa|AD
Aciculum|William Alston|Singapore|Top
Acid|Erika Lathrop|Iceland|Support
Acidfast|Stacy Stewart|China|Sub
Acidforming|Sheryl Carmack|Denmark|Sub
Acidhead|Mary Payton|Ukraine|Jungler
Acidic|Dan Hale|United States|AD
Acidify|Claudia Stein|Serbia|Top
Acidimeter|Walter Tammaro|Serbia|Jungler
Acidimetry|Betty Harvey|Malta|Mid
Acidity|Roy Houpe|Mexico|Jungler
Acidophil|Craig Scheuer|Colombia|Jungler
Acidosis|Sylvia Tingley|Mexico|Sub
Acidulant|Colleen Androlewicz|Indoensia|Top
Acidulate|Ethel Lambrakis|Chile|Support
Acidulent|Yvette Schweitzer|Mexico|AD
Acidulous|Sarah Morgan|Uruguay|Top
Acie|Albert Schoonover|Slovenia|Top
Acierate|Kathleen Goodsite|Vietnam|Sub
Acima|Betty Crowe|Uruguay|AD
Acinaciform|Lindsay Davis|Croatia|Top
Aciniform|Penny Devos|Estonia|AD
Acinus|Frederick Mixon|Poland|Sub
Acis|Mary Youngblood|China|AD
Ackack|Maximo Matthews|Israel|AD
Acker|Robert Gonzales|Czech Republic|Top
Ackerley|Darcy Lively|Lithuania|Mid
Ackerman|Michael Faler|United States|Sub
Ackler|Rodney Boone|Malta|Sub
Ackley|David Nelson|Panama|Jungler
Acklin|Ralph Hughes|South Korea|AD
Acknowledge|Teresa Lillpop|Chile|AD
Acknowledgment|Amanda Mobley|Poland|AD
Acme|Mary Petterson|Czech Republic|Mid
Acne|Mitchell Escalante|South Korea|Top
Acnode|Virginia Carter|Colombia|Sub
Acolyte|Frank Shearer|Estonia|Jungler
Aconcagua|Yesenia Salvage|United Kingdom|Jungler
Aconite|John Watts|Iceland|Support
Acord|Victor Wilson|Kazakhstan|Jungler
Acorn|Richard Gilliam|South Africa|AD
Acosmism|Carol Scott|Hungary|Support
Acosta|Larry Johnson|Slovenia|Support
Acotyledon|Dolly Paige|Chile|Jungler
Acoustic|Mary Ellis|Denmark|Jungler
Acoustician|Sherry Yoon|Australia|AD
Acoustics|Tyson Higgs|Slovenia|Sub
Acquah|Eileen Parker|South Korea|Sub
Acquaint|Carl Shaw|Peru|Support
Acquaintance|James Zimmer|Czech Republic|AD
Acquainted|Rose Bass|Taiwan|Top
Acquiesce|Josephine King|Uruguay|Top
Acquiescence|Augusta Coffee|Panama|Top
Acquiescent|Joel Wallace|France|Sub
Acquire|Charles Martinez|Macao|Support
Acquirement|Jeffry Fallon|Croatia|Jungler
Acquisition|Evelyn Jackson|Canada|Top
Acquisitive|Jesus Rivera|Israel|Jungler
Acquit|Patrick Place|Ukraine|Sub
Acquittal|Truman Hyneman|Estonia|Sub
Acquittance|Jimmie Herring|Croatia|AD
Acre|Barbara Ager|Canada|Support
Acreage|Joyce Daniels|Serbia|Mid
Acred|Kindra Day|Chile|AD
Acree|Isabelle Acker|Chile|Support
Acrefoot|Alvin Lewis|Thailand|AD
Acreinch|Randy Beeson|Canada|Top
Acrid|Janice Tsutsumi|Turkey|Jungler
Acridine|Nikki Doran|South Africa|Top
Acriflavine|Evelyn Blair|Estonia|Mid
Acrilan|Rosa Williams|United States|AD
Acrimonious|Peter Burch|Argentina|Mid
Acrimony|Kathleen Wentz|China|Mid
Acro|Diane Rodgers|Italy|Mid
Acrobat|Brittany Boyd|Hong Kong|Support
Acrobatic|Emma Hanson|Malta|AD
Acrobatics|Helen Sammartano|France|Mid
Acrocarpous|Charles Hanson|Norway|Sub
Acrodont|Doyle Rowe|France|Support
Acrodrome|Santa Castillo|Germany|Top
Acrogen|Richard Lear|Iraq|Jungler
Acrolein|Kayla Turbeville|Macao|Sub
Acrolith|Dennis Douglas|Armenia|Sub
Acromegaly|Angela Poque|Argentina|AD
Acromion|Carol Cook|Belgium|AD
Acronym|Ruth Maxwell|Greece|Sub
Acropetal|Julie Sert|South Africa|AD
Acrophobia|Christina Arkell|Israel|Top
Acropolis|Marilynn Burt|United Kingdom|Support
Acrospire|Viola Martin|Finland|Mid
Across|Kenneth Hersha|Slovenia|Jungler
Acrosstheboard|Kathy Meyers|Hungary|AD
Acrostic|Mary Lynch|Indoensia|Support
Acroter|Jason Yamashiro|South Africa|AD
Acroterion|John Hardesty|Philippines|Mid
Acrylic|Isabella Waters|Argentina|Support
Acrylonitrile|Dorothea Hockman|Uruguay|Top
Acrylyl|Kathleen Willadsen|Macao|AD
Act|Angela Tallie|Kazakhstan|Jungler
Actable|Bryan Holmes|United Kingdom|Mid
Actaeon|Wade Byrnes|Russia|Jungler
Acth|Jack Mova|Thailand|Support
Actin|Rebecca Richardson|Afghanistan|Top
Actinal|Mary Mcneil|South Africa|Sub
Acting|Mable Burgoon|Kazakhstan|AD
Actinia|Robert Monroe|Sweden|Support
Actinic|Virginia Jung|Malta|AD
Actiniform|Debra Kelly|Croatia|Mid
Actinism|Patricia Hutson|Armenia|Jungler
Actinium|Eddie Hines|Israel|AD
Actino|Alice Thomas|Macao|Sub
Actinochemistry|Mitchell Daly|France|Mid
Actinoid|Jennifer Cooper|Chile|Top
Actinolite|Evelyn Daniels|Slovenia|Sub
Actinology|Mindy Casano|Estonia|AD
Actinometer|Jessie Spencer|Singapore|Sub
Actinomorphic|Michael Voorhis|United States|Mid
Actinomycete|Adela Placido|Argentina|Support
Actinomycin|Clyde Reed|Russia|Jungler
Actinomycosis|Joseph Parshall|Italy|AD
Actinon|Roy Kennedy|Colombia|Jungler
Actinopod|James Wilkinson|Serbia|Mid
Actinotherapy|Darrin Lacefield|Hong Kong|Mid
Actinouranium|James Stanton|Thailand|Top
Actinozoan|Brian Anderson|Panama|Mid
Action|Janice Mcquay|Finland|Sub
Actionable|Charles Saysongkham|Portugal|Mid
Actium|Lyndsay Jackson|Israel|Top
Activate|Arthur Bollinger|Colombia|AD
Activator|June Mays|Philippines|Sub
Active|Reginald Woodward|Iraq|AD
Activism|Diana Johnson|Canada|Mid
Activist|Gloria Brasher|Ukraine|Sub
Activity|Debra Terrell|Slovenia|Jungler
Actomyosin|Fernando Marier|Indoensia|Mid
Acton|Christina Duffy|Slovenia|Sub
Actor|Michael Hinds|Macao|AD
Actress|Vanessa Munari|Peru|AD
Actual|Lionel Joe|Peru|Support
Actuality|Shana Dwaileebe|Croatia|Top
Actualize|Anthony Ramos|United States|Jungler
Actually|Rafael Vowell|Mexico|Top
Actuary|Doris Maria|Serbia|Mid
Actuate|Julie Clark|Serbia|Support
Acuate|Fred Nickerson|Singapore|Sub
Acuff|Larry Benitez|Italy|AD
Acuity|Mamie Horne|Chile|Sub
Aculeate|Harriette Cropp|Lithuania|Jungler
Aculeus|Gary Duryea|Thailand|AD
Acumen|Jacob Lee|Russia|Jungler
Acuminate|Leila Herrera|Estonia|Jungler
Acuna|Bonnie Black|Indoensia|Jungler
Acupuncture|Sylvia Hawkin|Australia|Top
Acus|Freddie Caro|Singapore|Support
Acutance|Brian Spencer|Canada|AD
Acute|Sarah Robinson|South Korea|Top
Acyclic|Judy Bennett|Sweden|Jungler
Acyl|Brenda Fritz|Ukraine|Mid
Ad|Mary Baklund|Thailand|Support
Ada|Joanna Gordon|Kazakhstan|AD
Adaadabel|Jan Mumaw|Lithuania|AD
Adabelle|Elvina Crist|Philippines|Jungler
Adachi|Joan Ali|Australia|Support
Adactylous|Dustin Khalil|Armenia|Jungler
Adage|James Long|United Kingdom|Jungler
Adagietto|Rosa Avery|China|Sub
Adagio|Lettie Dietzel|South Africa|Support
Adah|Kevin Mcfalls|Italy|AD
Adahadaha|Thomas Deerman|Iraq|AD
Adai|Jose Montes|Denmark|AD
Adaiha|Jermaine Farris|Afghanistan|Top
Adair|John Hanson|United States|Top
Adal|Paul Young|Costa Rica|Jungler
Adala|Zachary Cote|Taiwan|Sub
Adalai|Amanda Yazzie|Hong Kong|Jungler
Adalard|James Schultz|Hong Kong|Support
Adalbert|Petra Carty|Poland|Sub
Adalbertoadalheid|Lillian Buck|Netherlands|Top
Adali|Sammie Mullins|France|Top
Adalia|Rosemary Tyler|Panama|Top
Adaliah|Linda Todd|Malta|Jungler
Adalie|Lance Mendez|Colombia|Jungler
Adaline|Margareta Peeples|Peru|Support
Adalineadall|Mark Dunn|United Kingdom|Support
Adallard|Clifford Champlin|Malta|Jungler
Adam|Kyle Jefferson|Singapore|Mid
Adama|Willard Meis|South Africa|Top
Adamandeve|Richard White|Poland|Support
Adamant|Shana Street|Chile|Top
Adamantine|Paula Malone|Australia|Top
Adame|Brian Dunlap|Peru|Top
Adamec|Myles Murphy|Hong Kong|Top
Adamek|Martha Woods|Panama|AD
Adames|John Nichols|Australia|Support
Adamic|Mary Paulson|Malta|Support
Adamik|Maria Flores|Mexico|AD
Adamina|Mary Perdue|Czech Republic|Top
Adaminah|Galen Wenstrom|Netherlands|Sub
Adamis|Christopher Flansburg|Ukraine|Sub
Adamite|Bertha Jean|Afghanistan|AD
Adamo|Donna Crittle|Thailand|Mid
Adamok|Daniel Colligan|Greece|Sub
Adams|Benjamin Shimizu|Poland|Sub
Adamsen|Becky Flores|Portugal|Sub
Adamsite|Ann Golan|Czech Republic|Support
Adamski|Tony Mcneil|Italy|Mid
Adamson|Thaddeus Moore|Lithuania|Jungler
Adamsun|Melissa Drye|Russia|Jungler
Adan|Betty Conner|Iraq|Top
Adanadana|Sandra Fielder|Italy|Jungler
Adao|Marian Goines|Iraq|Support
Adapa|Joel Cutter|Thailand|Mid
Adapt|Joseph Zollars|South Korea|Sub
Adaptable|Daniel Gray|Hong Kong|Top
Adaptation|Brian Fleming|Indoensia|Mid
Adapter|Linda Pacheco|Malta|Jungler
Adaptive|Ted Nading|Hungary|Top
Adar|Karen Serpa|Mexico|Sub
Adara|William Dowd|Finland|Support
Adaurd|Ana Takacs|Estonia|Sub
Adaxial|Julia Morgan|Iraq|Sub
Aday|Melissa Gjertsen|Germany|AD
Adcock|Stacy Potts|Lithuania|Sub
Add|Albert Wright|South Africa|Jungler
Adda|William Lambert|Panama|Mid
Addam|Larry Mclaughlin|Spain|AD
Addams|Julio Marin|Ecuador|Top
Addax|Mary Mcconnell|United Kingdom|Jungler
Addend|Barbara Bruce|South Korea|Jungler
Addendum|Peter Searchwell|Chile|Top
Adder|Stephen Rodriguez|United Kingdom|Sub
Addi|Judy Haggard|Netherlands|Mid
Addia|Fred Mcinturff|Philippines|Mid
Addict|Sergio Luu|Vietnam|AD
Addicted|William Leon|Australia|Sub
Addiction|Rebecca Strickland|Portugal|Top
Addictive|Mary Long|Singapore|AD
Addie|Lydia Latham|United States|Sub
Addieaddiego|Devin Hinojosa|Italy|Jungler
Addiel|Roberta Stafford|Hungary|Top
Addington|Donald Jones|Thailand|Top
Addis|Brenda Baldwin|Kazakhstan|Jungler
Addison|Micheal Schiefelbein|United States|Sub
Additament|Charles English|Iceland|Sub
Addition|Deborah Bolk|Russia|Sub
Additional|Brian Rister|South Africa|AD
Additive|Karen Vise|Ecuador|Top
Additory|Anne Adkins|Poland|Support
Addle|Beatrice Phillips|Malta|Support
Addlebrained|Laura Chambers|Poland|Support
Addlepated|Mark Scherr|Slovenia|Support
Address|Joel Adam|Costa Rica|Support
Addressee|Simon Young|France|Top
Addressograph|Dalton Andersen|Sweden|Top
Adduce|Emily Gregory|United States|Jungler
Adduct|Timothy Maldonado|Ukraine|Mid
Adduction|Steven Bonita|Serbia|AD
Adductor|Anna Rodriguez|Hungary|AD
Addy|Jacquline Frailey|Macao|Top
Ade|Alberta Karter|Philippines|Support
Adebayo|Stacy Lineberry|Estonia|AD
Adel|Blanche Jubilee|China|Jungler
Adela|Lyle Smith|Czech Republic|Sub
Adelaadelaida|Kathleen Bergstresser|Singapore|Jungler
Adelaidaadelaide|Christian Pyatt|Iraq|Jungler
Adelaideadelaja|Jane Cruz|United States|AD
Adelbert|Talia Kelley|Argentina|Support
Adele|Ronald Yan|Canada|Top
Adeleadelheid|Marcella Porter|Portugal|Top
Adelia|Faye Polito|Estonia|Support
Adeliaadelice|Ivan Atkinson|Germany|Top
Adelina|James Nobles|Luxembourg|Mid
Adelinaadelind|Kim Jackson|Spain|Support
Adeline|William Hartigan|Taiwan|Mid
Adellaadelle|Katrina Rios|Brazil|Jungler
Adelladella|Michael Reed|Singapore|Top
Adelleadelpho|Debra Dolly|Luxembourg|Top
Adelric|Andrew Briggs|Estonia|Jungler
Ademption|Jacob Morris|South Africa|Jungler
Aden|Aleshia Alvarez|Mexico|Jungler
Adena|Sharon Vasta|Costa Rica|Mid
Adenaadenauer|Carroll Rosa|Brazil|Sub
Adenectomy|Sadie Lively|Belgium|Jungler
Adenine|Kelly Roach|United Kingdom|Mid
Adenitis|Dean Ziego|Uruguay|AD
Adeno|Diane Roza|Canada|Mid
Adenocarcinoma|Andrew Glass|Estonia|Mid
Adenoid|Walter Bocanegra|France|AD
Adenoidal|Darlene Ezell|Canada|AD
Adenoidectomy|Shelli Harness|Mexico|Sub
Adenoma|Ethan Putman|Japan|Top
Adenosine|Mario Williams|Taiwan|Mid
Adenovirus|Eric Hooks|Poland|AD
Adept|Jaime Bureau|Spain|Support
Adequacy|Pamela Vasquez|Turkey|Support
Adequate|Andrea Numbers|Panama|Sub
Ader|Charles Salazar|Hungary|Jungler
Adermin|Saundra Pike|Estonia|AD
Adessive|Kimberly Stinson|Peru|Sub
Adest|Cheryl Gibson|Poland|Top
Adey|Beverly Ortiz|Italy|AD
Adham|Lance Tan|Iceland|Jungler
Adhamh|Karen Carrasquillo|China|Support
Adhere|Jose Gagnon|Indoensia|Support
Adherence|Steve Averill|Slovenia|Mid
Adherent|Jesse Roberts|Portugal|Sub
Adhern|Lynne Dowdy|Malta|Support
Adhesion|Linda Little|Turkey|AD
Adhesive|Willie Hastings|Portugal|Jungler
Adhibit|Ivette Green|Peru|Mid
Adi|Joseph Sieberg|Vietnam|Jungler
Adiabatic|Hattie Wilson|Turkey|Top
Adiana|Alan Ervin|Portugal|Top
Adiaphorism|Maria Murphy|Denmark|AD
Adiaphorous|Jordan Cultice|Russia|AD
Adiathermancy|Howard Taylor|Thailand|AD
Adiel|Shirley Kimura|Netherlands|Mid
Adiell|William Hall|Ecuador|AD
Adieu|Jan Heard|Philippines|Top
Adige|Victoria Wright|Israel|Top
Adigranth|Dale Tavares|Estonia|Support
Adigun|Joshua Koch|Canada|Mid
Adila|Kelly Pelletier|Norway|Top
Adim|Alice Hooker|Chile|Support
Adin|Rex Rastorfer|Chile|AD
Adina|Diana Hill|United States|Sub
Adinaadine|Stephany Schmitt|Spain|Sub
Adios|Mary Wood|Indoensia|Mid
Adipocere|Amber Yurek|Slovenia|AD
Adipose|Kathleen Fierro|Peru|Support
Adis|Connie Wade|Peru|Top
Adit|Kenneth Cha|China|AD
Adjacency|Latoya Eatmon|Malta|Sub
Adjacent|Valerie Roberts|Armenia|AD
Adjectival|Heather Hogg|Czech Republic|Top
Adjective|Leroy Carmody|Lithuania|Sub
Adjoin|David Gordon|Singapore|Sub
Adjoining|Thomas Keller|Singapore|AD
Adjoint|Joyce Shumaker|Canada|Top
Adjourn|Arthur Go|Iceland|Support
Adjournment|Dollie Pynes|Israel|Top
Adjudge|Theresa Brucculeri|Argentina|Support
Adjudicate|Travis Mcintosh|United Kingdom|Mid
Adjudication|Danny Estes|Indoensia|Support
Adjunct|Dan Mitchell|Argentina|AD
Adjunction|Jason Bradbury|Argentina|Mid
Adjure|Anthony Martinez|Malta|Top
Adjust|Robert Bohnen|Taiwan|AD
Adjustment|Carrie Butler|Malta|Support
Adjutant|Paul Hauger|Philippines|Mid
Adjuvant|Alfredo Snow|Japan|Mid
Adkins|Mary Duarte|Canada|Top
Adkinson|Jason Stachowiak|France|Support
Adkison|Percy Jackson|Belgium|Top
Adkisson|Robert Witte|Vietnam|AD
Adlai|Brenda Mccarron|Afghanistan|Top
Adlar|Roger Mason|Mexico|Mid
Adlare|Bruce Rierson|Kazakhstan|Jungler
Adlay|Dorothy Bernard|Serbia|AD
Adlee|Pierre Scott|Indoensia|AD
Adlei|Kelvin Sizemore|Germany|AD
Adler|Caroline Dona|Iraq|AD
Adley|Kevin Rojas|Argentina|Mid
Adlib|Bette Jackson|Serbia|Sub
Adman|Eugene Bates|Australia|Jungler
Admass|Dale Langford|Iceland|AD
Admeasure|Fatima Martin|Iraq|Top
Admeasurement|Daniel Reed|South Africa|AD
Admetus|Diane Schultz|Macao|Sub
Adminicle|Maria Green|Italy|Support
Administer|Andrea Shutt|Norway|Sub
Administrate|Fay Wapp|Afghanistan|AD
Administration|Carol Becker|Netherlands|Jungler
Administrative|Matthew Pride|Costa Rica|Support
Administrator|Jason Ogle|Argentina|Sub
Admirable|Ernesto Taylor|Hungary|Sub
Admiral|Meta Dominguez|Afghanistan|Support
Admiralty|Martha Malek|Israel|Mid
Admiration|Catherine Julian|Indoensia|Mid
Admire|Dan Osborne|Portugal|AD
Admissible|Johnny Conover|Italy|Sub
Admission|John William|Finland|Support
Admissive|Janice Reid|Taiwan|Sub
Admit|Martha Fugate|Afghanistan|Support
Admittance|Martha Schmidt|Serbia|Top
Admittedly|Tammy Bassett|Ecuador|Sub
Admix|Terri Troutt|Taiwan|Sub
Admixture|Theresa Leonhardt|Belgium|Jungler
Admonish|Darryl Joyner|United Kingdom|Mid
Admonition|Thomas Grupe|Greece|Support
Admonitory|Jennifer Vinson|Slovenia|Jungler
Adna|Amanda Strebe|Czech Republic|Jungler
Adnah|Sharon Land|Chile|Mid
Adnate|Deborah Penney|Iraq|Top
Adne|Patricia Shoji|Denmark|Mid
Adnopoz|Joe Padilla|Israel|Jungler
Ado|Richard Degnan|Japan|Top
Adobe|Sandra Osorio|Germany|AD
Adolescence|Rita Morgan|United Kingdom|Mid
Adolescent|Luke Harvey|Finland|Top
Adolf|Peggy Williams|Taiwan|Sub
Adolfo|Shannon Rolf|Serbia|AD
Adolfoadolph|Floyd Cole|China|Support
Adolphadolphe|Eric Stagnaro|Denmark|Support
Adolpho|Joe Brakefield|Norway|Mid
Adolphus|Paul Rios|Australia|Top
Adon|Kristin Morrill|Hungary|Mid
Adonai|Alan Carter|Ukraine|Mid
Adonic|Arthur Borden|Argentina|Jungler
Adonis|Theodore Evans|Indoensia|Jungler
Adopt|Katie Garcia|Estonia|Mid
Adopted|Kevin Grenier|Turkey|Jungler
Adoptive|Stanley Keding|Turkey|Sub
Adora|Sheila Johnson|Afghanistan|Support
Adorable|Helen Lancon|Hungary|AD
Adoration|Benjamin Lim|Hungary|Mid
Adore|Marco Wells|South Africa|Jungler
Adoree|William Vest|Singapore|Support
Adorl|Alexander Baker|Kazakhstan|Support
Adorn|Michael Hidinger|Mexico|Sub
Adorne|Mae Fields|Argentina|Mid
Adornment|Edna Rogers|Russia|Sub
Adorno|Joseph Quint|Portugal|Sub
Adowa|Johnathan Cooper|Slovenia|Mid
Adown|Gary Becker|Iraq|Jungler
Adp|Cindy Rabelo|Japan|Top
Adrastus|Virgil Pollick|Norway|Support
Adrea|Gregory Tracey|Singapore|Sub
Adrell|Virginia Calderon|Sweden|Sub
Adrenal|Dolores Clark|United Kingdom|AD
Adrenalin|Joseph Lin|Vietnam|Sub
Adrenaline|Kara Hill|Kazakhstan|Sub
Adrenocorticotropic|Kathryn Waugh|Indoensia|Jungler
Adria|Carolyn Sandoval|Turkey|Top
Adriaadriaens|Viola Rosenberg|Brazil|Top
Adrial|Mark Topolosky|Hong Kong|Support
Adrian|Bernice White|Iceland|AD
Adrianaadriane|Tim Mcmasters|Poland|Sub
Adrianadriana|Joshua Miller|Vietnam|Top
Adrianeadrianna|Nancy Oliveras|Panama|Top
Adriannaadrianne|Katherine Taylor|Thailand|AD
Adrianneadriano|Annabelle Volz|Poland|Support
Adrianople|Tom Welch|Armenia|AD
Adriatic|Jason Mankel|Armenia|AD
Adriel|Merle Rodriguez|Serbia|Jungler
Adriell|William Morris|Taiwan|Sub
Adrien|Bessie Lopez|Croatia|AD
Adrienadriena|Mildred Jones|China|Support
Adriene|Douglas Thomas|Estonia|Support
Adrieneadrienne|Anthony King|Taiwan|Mid
Adrienneadrift|Nikki Flores|Chile|Top
Adroit|Patsy Saunders|Ecuador|Mid
Adscititious|Ellen Alvarado|Norway|AD
Adscription|Rita Turner|Denmark|Mid
Adsorb|Judy Payne|Philippines|Mid
Adsorbate|Lilian Byrne|Mexico|Jungler
Adsorbent|Robert Saxbury|Estonia|Sub
Adularia|Eric Grant|Brazil|AD
Adulate|Barbara Delacruz|Malta|Top
Adulation|Theodore Barbosa|Estonia|Mid
Adult|Nancy Pellegrino|Finland|Top
Adulterant|Nancy Beeler|Uruguay|Mid
Adulterate|Margaret Johnson|Serbia|Support
Adulteration|Joann Dotson|South Korea|Jungler
Adulterer|Raymond Garcia|Czech Republic|Support
Adulteress|Helen Foody|Chile|Sub
Adulterine|Johnny Ford|Estonia|Sub
Adulterous|John Leone|Serbia|AD
Adultery|Maurice John|Australia|Top
Adulthood|David Jones|Hong Kong|Jungler
Adumbral|Joan Person|Afghanistan|Support
Adumbrate|Joshua Jones|Poland|Mid
Adur|Larry Greene|Armenia|Support
Adust|Mandi Fowler|Norway|Top
Aduwa|Peter Adams|Poland|Sub
Advance|Eleanor Kraeger|Portugal|AD
Advanced|Robert Mata|Portugal|Jungler
Advancement|Scott Gerald|Poland|Top
Advantage|Muriel Kasprowicz|Israel|Mid
Advantageous|Travis Durham|Mexico|Jungler
Advection|Teri Hollingsworth|Uruguay|Mid
Advent|Terry Guiles|Ukraine|Support
Adventist|Norman Bonawitz|Finland|Mid
Adventitia|Tom Evans|Iraq|Top
Adventitious|Patricia Lopez|Malta|Jungler
Adventure|Robert Bell|Germany|AD
Adventurer|Jennifer Trapani|Denmark|AD
Adventuresome|John White|Kazakhstan|Mid
Adventuress|Linh Cotton|Belgium|Mid
Adventurism|Marian Dufrene|Indoensia|Jungler
Adventurous|Michael Meaker|Iceland|Support
Adverb|Jerilyn Defelice|Kazakhstan|Top
Adverbial|David Peterson|Turkey|Top
Adversaria|Stacey Salvietti|Finland|Sub
Adversary|Maude Hulse|Luxembourg|Top
Adversative|Jose Young|Norway|Support
Adverse|Brent Villegas|Philippines|Sub
Adversity|Enrique Frizzell|Sweden|Support
Advert|Roger Jones|Thailand|Mid
Advertence|Lisa Strope|Belgium|AD
Advertent|Dinah Johnson|Peru|Jungler
Advertise|Lydia Thomas|Germany|Sub
Advertisement|Gwendolyn Johnson|Norway|Sub
Advertising|George Cole|Netherlands|AD
Advice|Gregory Mcneil|Portugal|Mid
Advisable|Matthew Thomas|Taiwan|Sub
Advise|Rosa Nye|Canada|Mid
Advised|Karen Hilt|Singapore|AD
Advisedly|Flora Garcia|Vietnam|Support
Advisee|Janet Mccullar|Ukraine|AD
Advisement|Ophelia Warnke|France|Jungler
Adviser|Giovanni Herrington|Chile|Jungler
Advisory|Dean White|Germany|Sub
Advocaat|Edward Bies|Malta|Jungler
Advocacy|Lena Ward|United Kingdom|Sub
Advocate|Robert Atkinson|Malta|Top
Advocation|Charles Donald|Singapore|Top
Advowson|Lynne Saunders|Netherlands|Mid
Adynamia|Frederick Gunnels|Hungary|Top
Adytum|Ronald Akbar|Costa Rica|Mid
Adz|Debbra Odum|Chile|Jungler
Adze|Hans Marsh|Russia|Sub
Aec|Ivan Levasseur|Armenia|Mid
Aeciospore|Joseph Hoey|Japan|AD
Aecium|Eleanor Guimond|Lithuania|Mid
Aedes|Michael Freeman|United Kingdom|Mid
Aedile|Henrietta Fisher|Panama|Mid
Aegaeon|William Young|Hungary|Mid
Aegean|Enrique Arenas|Czech Republic|Support
Aegeus|Kathryn Harwell|Argentina|Mid
Aegina|Benjamin Fordyce|Japan|Jungler
Gunslinger|Stanley Fields|Estonia|AD
Gunsmith|Kathy Thomas|Armenia|Sub
Gunstock|Frank Cook|Vietnam|Support
Guntar|Bonnie Link|Costa Rica|Jungler
Gunter|William Rodriguez|Chile|Top
Gunthar|Sarah Clark|Peru|Mid
Gunther|Timothy Harrison|Croatia|Sub
Gunwale|Rachel Taylor|Chile|Top
Gunyah|Joe Lyons|China|AD
Gunzburg|Franklin Snyder|Norway|Mid
Guppy|Denise Smith|United States|Support
Gupta|Victoria Roll|Uruguay|Top
Gupton|Judy Parisi|Taiwan|AD
Gur|Katelyn Goldizen|Denmark|AD
Gurango|Esther Hudock|Germany|Top
Gurdwara|Irene West|Hong Kong|Top
Gurevich|Trey Elbert|United Kingdom|Mid
Gurge|Eugene Fields|Iraq|Sub
Gurgitation|Henry Nordberg|Armenia|Jungler
Gurgle|Donny Stanton|Denmark|Top
Gurglet|Karen Robinson|Greece|Jungler
Guria|Kevin Silva|Japan|Jungler
Gurias|Leslie Bryant|Australia|AD
Gurkha|Tony Hill|Luxembourg|Mid
Gurl|Jame Davidson|Lithuania|Mid
Gurley|Edward Townsend|Malta|Support
Gurnard|Sandra Davis|South Korea|Top
Gurney|Bernice Cornett|Serbia|Top
Gurolinick|Melissa Coon|Norway|AD
Gurrola|Hayley Ryan|Taiwan|Support
Gurtner|Kim Reyes|Finland|Mid
Guru|Beth Radley|Colombia|Top
Gurule|Matthew Thomas|Vietnam|Support
Gus|Kendrick Davis|South Korea|Support
Gusella|Myrna Peters|Mexico|AD
Gusgusba|Mary Barragan|Thailand|Mid
Gush|Miriam Fogg|Hong Kong|Support
Gusher|Donald Ahmed|Philippines|Sub
Halm|Lee Watkins|Hong Kong|AD
Halmahera|Leslie Lande|China|AD
Halmstad|Marion Numbers|Portugal|Mid
Halo|Frances Lafave|Uruguay|AD
Halogen|Connie Thomas|Serbia|Mid
Halogenate|Garland Harrison|Uruguay|Jungler
Haloid|Fallon Spencer|Mexico|AD
Halona|Katherine Daly|Israel|Jungler
Halonna|Dennis Emrick|Slovenia|Jungler
Halophyte|Travis Simmerman|Uruguay|AD
Halothane|Mercedes Fisher|France|Sub
Halpern|James Wagnon|Australia|Jungler
Halpin|Dorothy Jennings|Ecuador|Support
Hals|Manuel Sims|Iraq|Mid
Halsey|Lori Desjardins|Armenia|Mid
Halstead|Jerry Shepard|Argentina|Mid
Halsted|Chester Isbell|Armenia|Mid
Halsy|Ashley Hiatt|Portugal|Top
Halt|Ardith Rivet|Spain|Sub
Halter|Cherie Zamora|Iceland|Mid
Halting|Sylvia Duncan|Peru|Top
Halutz|Michael Farlow|Slovenia|Mid
Halvaard|Patrick Middleton|Norway|Mid
Halvah|Kimberly Jennings|Afghanistan|Top
Halve|Elvis Pacific|Brazil|AD
Halverson|Gonzalo Wilmot|Thailand|Top
Halves|Charles Seiler|Thailand|Jungler
Halvorsen|John Martinez|United Kingdom|Support
Halvorson|Patrick Pearce|Hong Kong|AD
Halyard|Michael Matthews|Norway|Sub
Ham|Rita Chiariello|Taiwan|AD
Hama|Elsie Harrison|Philippines|AD
Hamachi|Nancy Ehlers|Portugal|Mid
Hamadryad|Cory Luse|Serbia|Jungler
Hamal|Harriett Boman|Colombia|Sub
Hamamatsu|Tasha Perkins|Hungary|Sub
Hamamelidaceous|John Ramirez|Iceland|Sub
Haman|Jessie England|Sweden|Support
Hamann|Kevin Acklin|Denmark|Jungler
Hamartia|Emerald Mcfadden|Uruguay|Support
Hamate|Rhonda Smart|Italy|Top
Hambletonian|Myrtle Davis|Portugal|Sub
Hambley|William Shiels|Uruguay|Jungler
Hamblin|Alice Thompson|Israel|Jungler
Hambrick|Louis Paci|Hong Kong|Top
Hamburg|Jamie Petty|Portugal|Jungler
Hamburger|Shauna Cervantes|Portugal|Jungler
Hamby|Abraham Rees|Luxembourg|Top
Hame|Leora Head|South Korea|Sub
Hamel|Fred Wilken|Estonia|Sub
Hamelin|Bonita Bowland|Japan|Sub
Hamer|Lynne Mcgraw|South Korea|Mid
Hames|Brad Erickson|Argentina|AD
Hamford|Jerome Mcqueen|Greece|Sub
Hamforrd|James Ament|Luxembourg|Support
Hamfurd|Marjorie Green|Hungary|Sub
Hamhung|Johnathan Harshbarger|Turkey|Top
Hamid|Carol Blandon|Indoensia|Jungler
Hamil|Jerry Almeida|Chile|Support
Hamill|Julie Clyde|Italy|AD
Hamilton|Elias Inman|United States|Mid
Hamiltonian|Pearl Taylor|Panama|Sub
Hamish|Patricia Nesbitt|Colombia|AD
Hamite|Eugene Helms|France|Support
Hamitic|Sarah Mccabe|Macao|Support
Hamitosemitic|Sandra White|Colombia|Mid
Hamlani|Judy French|Croatia|Jungler
Hamlen|Francisco Zamarripa|Brazil|AD
Hamlet|Jay Gross|Panama|Jungler
Hamlett|Theodore Stenson|Argentina|Mid
Hamlin|Dan Dawson|South Africa|AD
Hamm|Judith King|Iceland|Sub
Hammack|Jane Rayfield|Peru|Support
Hammad|Craig Ennis|Macao|Jungler
Hamman|Michael Aburto|Colombia|Jungler
Hammel|Ann Gregoire|Kazakhstan|Sub
Hammer|Vera Barcenas|Estonia|Mid
Hammered|Mary Yao|Ecuador|Top
Hammerfest|Levi Copley|Colombia|Support
Hammerhead|James Giesen|Finland|AD
Hammering|Matthew Malloy|Spain|AD
Hammerless|Elizabeth Peed|Vietnam|Jungler
Hammerlock|Rocky Burton|South Korea|AD
Hammers|Kent Lorenzo|Vietnam|AD
Hammerskjold|Luz Pruitt|Russia|AD
Hammertoe|Henry Motley|Slovenia|Top
Hammett|Eric Best|Argentina|Support
Hammock|Kevin Garcia|Iraq|Mid
Hammon|Anne Hicks|Estonia|Support
Hammond|Kenneth Nelson|Uruguay|Mid
Hammonds|Jean Gallegos|Kazakhstan|Sub
Hammons|Holly Johnson|China|AD
Hammurabi|Tessie Tweedy|Netherlands|Mid
Hammy|Corinne Mathews|Luxembourg|Support
Hamner|Robert Nguyen|Israel|Support
Hamnet|Stephanie Walz|Russia|AD
Hamo|Judy Oldfield|Macao|Support
Hamon|Martha Sterns|Sweden|Mid
Hampden|Patricia French|Thailand|Top
Hamper|Monica Beal|Singapore|Support
Hampshire|William Mccombs|United Kingdom|Sub
Hampson|Kathy Bermudez|Afghanistan|AD
Hampstead|David Brown|Singapore|Mid
Hampton|Siu Rogers|Portugal|Mid
Hamrah|David Mcdaniel|Slovenia|Top
Hamrick|Mattie Schneider|Costa Rica|Support
Hamrnand|Kevin Ruiz|Japan|Support
Hamster|Raul Voelkel|Spain|Top
Hamstring|Sharon Lawson|Costa Rica|AD
Hamsun|Merle Roberts|Peru|Support
Hamulus|Alexander Beveridge|Sweden|Jungler
Hamza|Robert Hall|Costa Rica|Sub
Han|Dorothy Locks|Ukraine|Sub
Hanafee|Byron Morgan|Kazakhstan|Top
Hanahanae|Jennifer Matthews|Iceland|Sub
Hanako|Ruben Daisley|Estonia|Support
Hanan|Maryann Mickelsen|Argentina|Sub
Hanaper|David Stolz|Finland|Mid
Hance|Travis Anchors|Iraq|Top
Hancock|Todd Morrell|Turkey|Sub
Hand|Michael Bender|Turkey|Support
Handal|Jeffery Foley|Finland|Jungler
Handbag|Pauline Davis|Estonia|Jungler
Handball|David Williams|Singapore|Mid
Handbarrow|Tommy Colligan|Germany|Sub
Handbill|Joanne Harris|Brazil|Sub
Handbook|Cedric Whipple|Serbia|Jungler
Handbreadth|Ned Cherry|Colombia|Top
Handcar|Sean Bembry|Colombia|Jungler
Handcart|Alton Prieto|Hong Kong|Support
Handclap|Heather Hill|Germany|Support
Handclasp|Caren Hileman|Afghanistan|Mid
Handcraft|John Workman|Peru|Sub
Handcrafted|Blake Stewart|Mexico|Support
Handcuff|Donald Mitchell|United States|Jungler
Handed|Teresa Aubuchon|Indoensia|Sub
Handedness|Julie Western|Luxembourg|Sub
Handel|Alma Gates|Sweden|Jungler
Handfast|Precious Silvers|Malta|Top
Handfasting|John Whalen|France|AD
Handful|Luz Brewton|Czech Republic|Mid
Handgrip|Annette James|Australia|Top
Handgun|Stanley Mckenzie|Serbia|AD
Handhold|Traci Stamm|Canada|Support
Handicap|Matthew Bowman|Mexico|Sub
Handicapped|Mary Noah|Australia|Mid
Handicapper|Ismael Lucas|China|Support
Handicraft|Stephen Walrath|Germany|Top
Handicraftsman|Adam Daniels|Ukraine|Jungler
Handily|Ted Marr|Denmark|Support
Handiness|Joan Mann|Portugal|Mid
Handiwork|Erika Jewell|Ukraine|Sub
Handkerchief|Latonia Stevens|Costa Rica|Jungler
Handknit|Elsy Tarpey|South Africa|Mid
Handle|Shanae Shawgo|Israel|AD
Handlebar|Gladys Jones|Denmark|Support
Handler|George Rollins|Argentina|Sub
Handley|Agnes Lindsay|Canada|Support
Handling|David Bradley|China|Sub
Handmade|Chris Payne|Hong Kong|Jungler
Handmaid|Chad Wilson|Russia|Jungler
Handmaiden|Douglas Smith|Panama|Mid
Handmedown|Gerald Daniel|Costa Rica|Mid
Handoff|Sandra Robinette|Kazakhstan|Top
Handout|Richard Wright|Peru|Support
Handpick|Kelli Levi|China|Jungler
Handrail|Sari Roberson|Italy|AD
Hands|Grace Anderson|Vietnam|AD
Handsaw|Mary Gilliam|Norway|Jungler
Handsel|Justin Kase|Turkey|Mid
Handset|Celeste Sandoval|Hungary|Top
Handshake|Mary Mathews|Lithuania|Jungler
Handshaker|Brenda Deno|Belgium|AD
Handsome|Christine Corwin|Thailand|AD
Handsomely|Nellie Golka|Finland|Top
Handspike|Frank Trivedi|Hungary|Mid
Handspring|Matthew Paugh|Japan|AD
Handstand|Marie Petrovich|United Kingdom|Mid
Handtohand|Sabrina Manning|Greece|AD
Handtomouth|David Mcclure|Brazil|AD
Handwork|James Harris|Belgium|Jungler
Handwoven|Yolanda Oestmann|Russia|Support
Handwriting|Sally Senno|China|Sub
Handy|Daniel Jean|Hungary|Sub
Handyman|Renee Hledik|Italy|Support
Hanes|Kimberly Peterson|Taiwan|AD
Haney|David Brock|Croatia|Jungler
Hanford|David Hartwig|Hong Kong|Support
Hanforrd|Maria Griffith|Estonia|AD
Hanfurd|Garrett Taylor|Lithuania|Sub
Hang|Jeremy Cumiskey|Netherlands|Top
Hangbird|Karyn Transou|Sweden|Top
Hangchow|Betty Freeman|South Africa|Jungler
Hangdog|Luis Terry|Norway|Top
Hanger|Alice Booker|Taiwan|Support
Hangeron|Mark Biondo|Australia|Top
Hanghangar|Stephen Paulsen|Ukraine|Top
Hanging|Robert Langer|South Africa|Sub
Hangman|Larry Aguilar|Netherlands|Support
Hangnail|James Keever|Poland|Top
Hangout|Fabian Franz|Greece|Top
Hangover|John Cooke|Portugal|Jungler
Hangup|Karen Pensinger|Iceland|Support
Hanhana|Francina James|Argentina|Mid
Hanhhank|Floyd Blethen|Iraq|Jungler
Hanker|Lester Doubet|Armenia|Sub
Hankering|Walter Kreiman|Italy|Top
Hankhanke|Jill Josselyn|Macao|Support
Hankins|Joan Casey|Philippines|AD
Hankow|Nancy Kemp|Lithuania|AD
Hanks|Wilhelmina Sheldon|Netherlands|Support
Hanky|Arthur Royster|Iraq|Support
Hankypanky|Grace Ramos|Spain|Top
Hanleigh|Patricia Kerley|Sweden|Mid
Hanley|Traci Kirkland|France|Jungler
Hanlon|Gregory Olewine|Thailand|Jungler
Hann|Pat Harris|Italy|Top
Hanna|Kathleen Banh|South Africa|Jungler
Hannah|Kimberly Sanchez|South Korea|Mid
Hannahannah|Susan Phelps|Germany|Support
Hannahhannan|Cynthia Whitten|Czech Republic|Jungler
Hannan|Barbara Sines|Netherlands|Mid
Hannelorehanner|Erica Resendez|United States|Sub
Hanni|Marcy Tello|South Africa|AD
Hannibal|Jeremiah Sanchez|Russia|Jungler
Hannie|Barbara Stanton|Italy|AD
Hannigan|Rosalba Johnson|Spain|Top
Hannis|Michael Peralta|Luxembourg|Sub
Hannon|Mindy Jacobson|Poland|Mid
Hannover|Nancy Amrhein|South Africa|Sub
Hannus|David Forbus|Lithuania|Top
Hanny|Karl Mendenhall|China|Support
Hanoi|Jeffrey Stone|Belgium|Sub
Hanover|Jennifer Ellis|South Korea|Support
Hanoverian|Carolyn Blevins|Iraq|Top
Hanrahan|Raymundo Albus|Denmark|Support
Hans|Nancy Neighbors|Lithuania|Mid
Hanschen|Judy Nishida|Mexico|Mid
Hanse|Eric Root|United States|Top
Hanseatic|Carolyn Vallee|China|Jungler
Hansel|Victor Rencher|Croatia|Mid
Hanselka|Michael Baca|Thailand|Support
Hansen|David Cobb|Singapore|Top
Hanser|Shannon Gabrielsen|Singapore|Jungler
Hanshansard|Helen Johnson|Serbia|Support
Hanshaw|Loris Campbell|United States|Sub
Hansiain|Emily Wise|Uruguay|Sub
Hansom|Matthew Korth|Turkey|Mid
Hanson|Amy Williams|Netherlands|Support
Hanukkah|Jacqueline Hudson|Thailand|Top
Hanuman|Lawrence Stubbs|Canada|Mid
Hanus|Ralph Drake|Macao|Support
Hanway|Carol Jolley|Slovenia|Jungler
Hanyang|Dorothy Bennett|Ecuador|Jungler
Hanzelin|Robert Jacques|Italy|Mid
Hap|Lyle Cooper|United Kingdom|Support
Haphazard|Linda Benauides|Spain|Top
Haphazardly|Jenna George|Vietnam|Top
Haphtarah|Bertha Stevens|Indoensia|Mid
Hapless|Victoria Simms|Colombia|Support
Haplite|Angeline Rhames|Colombia|Mid
Haplo|Eduardo Buchanan|Spain|Support
Haplography|Michael Parker|Portugal|Mid
Haploid|Tracey Rodriguez|Russia|Top
Haplology|Julian Breaux|Italy|Jungler
Haplosis|Alexis Abdullah|Croatia|Mid
Haply|Barbara Henley|Macao|Top
Happ|Charles Mcdowell|Finland|Mid
Happen|Minnie Cole|Ukraine|Sub
Happening|Kristin Farrell|Taiwan|Jungler
Happenstance|Laura Cole|Hungary|AD
Happily|Denise Dorman|Australia|Jungler
Happiness|Silvia Biddle|Armenia|Sub
Happy|Monica Bowman|Netherlands|Mid
Happygolucky|Jeffery Fields|Vietnam|Top
Hapsburg|Wendy Northover|Greece|Mid
Hapte|Herminia Boeck|Singapore|Mid
Hapten|Mary Reynolds|Finland|Top
Hara|Carl Vasquez|Kazakhstan|Sub
Harakiri|Julie Fowler|United Kingdom|AD
Harald|Justin Whyte|Serbia|Sub
Harangue|India Gallegos|Turkey|Sub
Harappa|Amelia Hronick|Chile|Sub
Harar|Clifford Breaux|Hungary|AD
Harass|Josh Villa|Denmark|Support
Harassed|William Shade|Spain|Jungler
Harbard|Tiffany Rogers|Portugal|Top
Harbaugh|Alyson Watson|Lithuania|Mid
Harber|Robert Naranjo|Poland|Sub
Harberd|Marilyn Nagy|Denmark|Jungler
Harbert|Robin Hackathorn|Estonia|Top
Harbin|Brandi Schreiber|Russia|AD
Harbinger|Elizabeth Yamaguchi|Slovenia|AD
Harbird|Clarence Albano|Finland|Top
Harbison|Martha Felten|Serbia|Support
Harbor|Mark Jaegers|Denmark|AD
Harborage|Gloria Vidrine|Brazil|Top
Harbot|Doris Mondell|Uruguay|Support
Harbour|Kenneth Kelly|France|Top
Harbourage|Evelyn Morris|Brazil|Mid
Harcourt|Felipe Davenport|South Africa|Jungler
Hard|Ronald Swisher|Macao|Top
Hardan|John Garner|Iraq|Mid
Hardandfast|Ralph Dyckman|France|Sub
Hardaway|Danielle Pruitt|Spain|Support
Harday|Sharon Padilla|Ecuador|Support
Hardback|Tina Pierce|Germany|Sub
Hardball|Kathryn Carter|Kazakhstan|AD
Hardbitten|Lonny Flanagan|Singapore|Mid
Hardboard|Frances Hillsgrove|Czech Republic|Jungler
Hardboiled|Karen Deweese|Hong Kong|Support
Hardcastle|Mary Hyatt|Kazakhstan|Sub
Hardcore|Levi Frazier|Afghanistan|Sub
Hardden|Holly Walker|Taiwan|Mid
Hardecanute|Jesse Garland|Lithuania|Mid
Hardee|Eleanor Courtney|Estonia|Sub
Hardej|Charlotte Loomis|France|Sub
Hardeman|Laura Greene|Taiwan|AD
Harden|Glenna Black|Turkey|Jungler
Hardenberg|Reyna Long|South Africa|Sub
Hardened|Robert Vanmatre|Mexico|Jungler
Hardener|Corina Mcdowell|Hong Kong|Support
Hardening|Eldon Rome|Greece|Sub
Harder|Amy Grinder|Netherlands|Sub
Hardesty|Christopher Lifford|Norway|Support
Hardfavored|Shanna Brewington|Chile|Sub
Hardfeatured|Ann Royster|Slovenia|AD
Hardhack|Anthony Yoakum|Italy|AD
Hardheaded|Steven Despain|Macao|Top
Hardhearted|Frances Bates|Ukraine|Top
Hardi|Julia Gibson|Uruguay|Top
Hardie|Wanda Lee|Germany|Sub
Hardigg|Josephine Bradley|Chile|Jungler
Hardihood|Timothy Santiago|Peru|Top
Hardily|Lisa Hawkins|Finland|Top
Hardiman|Joseph Oneill|Netherlands|Support
Hardin|Joseph Floresca|Australia|Mid
Hardiness|Erica Watkins|Norway|Support
Harding|Harry Carr|Belgium|Mid
Hardison|Lynn Trammell|Portugal|Support
Hardly|Calvin Rock|Brazil|AD
Hardman|Scott Nicholson|Iceland|Sub
Hardner|Joel Knox|Italy|Top
Hardness|John Beale|Philippines|Mid
Hardnett|Joe Aguilar|Lithuania|AD
Hardnosed|Donna Clark|Lithuania|Sub
Hardpan|Maria Smith|Thailand|Support
Hardpressed|Cherri Miesner|Afghanistan|Support
Hards|Karen Fite|Sweden|AD
Hardset|Edward Rodriquez|United Kingdom|Support
Hardshell|Robin Anglin|Poland|AD
Hardship|Robert Delbosque|Armenia|Mid
Hardspun|Norman Sorensen|China|Top
Hardtack|Magdalene Sweat|Norway|Top
Hardtop|Marguerite Olson|Slovenia|Sub
Hardunn|Eric Kaiser|Norway|Top
Hardware|Aaron Sharp|Finland|Jungler
Hardwick|John Raby|Portugal|Top
Hardwood|John Jordan|Colombia|Support
Hardworking|Renee Adames|South Africa|Support
Hardy|Shirley Anderson|Chile|Support
Hare|Jennifer Walls|Belgium|Sub
Harebell|Ruth Salazar|Ecuador|AD
Harebrained|Gary Ruminski|Armenia|AD
Harelda|Ruth Robb|Iraq|Top
Harelip|Daniel Barber|Kazakhstan|Sub
Harem|Wanita Mcdonald|Netherlands|Jungler
Harewood|Gerald Whittenbeck|Turkey|Top
Hargeisa|Aubrey Smith|Thailand|AD
Hargett|Anthony Kohler|Luxembourg|Jungler
Hargis|James Tucker|Netherlands|Support
Hargrave|Edward Jimenez|Finland|Jungler
Hargreaves|Joan Harper|Panama|Support
Hargrove|Thomas Marin|Chile|Mid
Harhay|Robin Mccolpin|Armenia|AD
Haricot|Kathleen Keating|Japan|AD
Harijan|Eduardo Lambert|Peru|Support
Harilda|Mattie Watters|Mexico|AD
Harim|Debbie Ackerman|Chile|Top
Hark|Ray Williams|Iceland|Jungler
Harken|Maggie Russell|Ecuador|Jungler
Harker|Jay Adler|Vietnam|Sub
Harkey|Sergio Bullion|Peru|Jungler
Harkins|Melanie Iniguez|Lithuania|AD
Harkness|Jenelle Willmore|Philippines|Support
Harl|Ruth Sulik|Luxembourg|Top
Harlamert|Mary Lowe|Hungary|Top
Harlan|Herman Moody|Turkey|Mid
Harlandharle|Grace Scheffler|Philippines|Top
Harlanharland|Sheri Rodriguez|Luxembourg|Support
Harleigh|Rachell Rascon|Argentina|Top
Harlem|Christina Avey|Italy|Sub
Harlen|Shelley Sierra|Japan|Mid
Harlene|Flora Nichols|Singapore|Mid
Harlequin|Cassandra Aguilar|Greece|Jungler
Harlequinade|John Johnson|Russia|Support
Harless|Ed Turner|United States|Jungler
Harley|Eduardo Uribe|Norway|Top
Harleyharli|Donna Matlock|Portugal|AD
Harlie|Christopher Beckman|South Korea|AD
Harlin|Evelyn Leonard|Vietnam|AD
Harlot|Berniece Hutchinson|Japan|Top
Harlotry|Irene Kelly|Armenia|Jungler
Harlow|Alonzo Knowles|Iraq|Mid
Harm|Bertha Harrell|China|Support
Harman|Glenda Kent|Malta|AD
Harmaning|Albert Craig|Poland|Support
Harmattan|Damien Rene|South Korea|Jungler
Harmful|Freddie Jones|Afghanistan|Top
Harmless|Meagan Rosenbarger|Colombia|Top
Harmon|Antonio Leek|Iceland|Support
Harmonia|Gabriel Thomas|Uruguay|Sub
Harmonic|Maria Stoney|Slovenia|Support
Harmonica|Willie Gomez|Finland|Top
Harmonicon|Carolyn Mossien|Thailand|Jungler
Harmonics|Annie Lopez|Philippines|AD
Harmonie|John Graves|Denmark|Top
Harmonious|Elroy Lerma|Canada|Top
Harmonist|Loretta Chupp|Hungary|Top
Harmonium|Karen Robinson|Czech Republic|AD
Harmonize|Jeannette Renolds|Ecuador|Top
Harmony|Lisa Treadway|United Kingdom|Mid
Harmonyharmotome|Elizabeth Myers|Thailand|AD
Harms|Nereida Washington|Turkey|Support
Harmsworth|William Smith|Malta|Sub
Harned|Robert Witt|Malta|Jungler
Harneen|Jose Schlosser|Argentina|Support
Harner|Carl Hernandez|Estonia|Mid
Harness|David Mendoza|Netherlands|Jungler
Harney|Edna Wiley|Japan|Support
Haro|Audry Styles|Kazakhstan|Mid
Harod|Walter Allen|Ecuador|AD
Harold|Jimmy Hulslander|China|Top
Haroldharolda|Tresa Washington|Brazil|Top
Haroldson|Virginia Schaming|Ecuador|Sub
Haroun|Deborah Coulson|Indoensia|Support
Harp|Clyde Chesney|Russia|Mid
Harper|Rudolph Simon|Norway|Top
Harping|Delores Turner|Indoensia|Top
Harpist|Donnie Parsons|Slovenia|Jungler
Harpole|Brian Hardister|Germany|Mid
Harpoon|Mark Apadoca|Costa Rica|AD
Harpp|Martin Slagle|Croatia|Mid
Harpsichord|Melissa Dellano|United Kingdom|AD
Harpy|Kermit Trask|Singapore|Jungler
Harquebus|James Franklin|Ukraine|Top
Harquebusier|Errol Wengel|Afghanistan|Sub
Harr|Edgar Murphy|Uruguay|Mid
Harragan|Mike Hess|Singapore|Top
Harrar|Kimberly Godfrey|Czech Republic|Mid
Harrell|Irene Donnelly|South Africa|Jungler
Harrelson|Theresa Hendrix|Australia|Mid
Harri|James Planas|Afghanistan|Top
Harridan|George Mello|Armenia|Top
Harrie|Nathan Camel|Portugal|Jungler
Harrier|Wayne Campos|Japan|Support
Harriet|Marion Johnson|Costa Rica|Jungler
Harrietharriett|Leona Saito|Iceland|Jungler
Harriette|Leonard Lonergan|Italy|Sub
Harrietteharrigan|Louis Hurtado|Philippines|Support
Harriettharrietta|Catina Valentine|Ukraine|AD
Harriman|Edward Linch|Italy|AD
Harrington|John Laney|United Kingdom|Sub
Harriot|Sean Smith|Russia|Support
Harriott|Matthew Booe|South Africa|Mid
Harris|Robert Cantrell|Germany|Top
Harrisharrisburg|Robert Casagrande|Iceland|Support
Harrison|Marjorie Ford|Colombia|Top
Harrisonharrod|Gloria Barnes|Philippines|Sub
Harrod|Allen Shaw|Norway|Mid
Harrold|Darlene Marine|Costa Rica|Mid
Harrovian|Stephen Jones|Armenia|Jungler
Harrow|Joyce Paul|Israel|Support
Harrumph|Sue Sands|South Africa|AD
Harrus|Jason Fresh|Hungary|Jungler
Harry|Karen Blomdahl|South Africa|Mid
Harryharsh|Mark Letchworth|Indoensia|Mid
Harsh|Ramona Barnes|United States|AD
Harshman|Stanley Presley|Brazil|Sub
Harsho|Levi Clark|Thailand|Top
Harslet|Laura Mccleary|Serbia|Mid
Hart|Rosemary Gracia|Finland|AD
Hartal|Rebecca Jack|Denmark|Support
Harte|Annie Lambert|Kazakhstan|Mid
Hartebeest|Don Crump|United Kingdom|AD
Harter|Ann Jordan|Iceland|Mid
Hartfield|Milton Atwood|Norway|Mid
Hartford|Christine Adams|Italy|Support
Hartill|Kevin Johnson|Croatia|Sub
Hartle|Adrienne Rance|Australia|Top
Hartley|Francis Albano|Macao|Support
Hartman|Jamie Reinhardt|Peru|AD
Hartmann|Virginia Lee|South Korea|Jungler
Hartmunn|Charles Packard|Australia|Sub
Hartnett|Eric Walz|Portugal|Mid
Harts|Jennifer Glenn|Kazakhstan|Mid
Hartsell|Brian Nieves|Mexico|Mid
Hartsfield|Cindy Alexander|Chile|Mid
Hartshorn|Adelina Bowman|Poland|Jungler
Hartsock|Rebecca Sharkey|France|AD
Hartung|Jeremiah Samuel|Ecuador|Jungler
Hartwell|Wallace Bell|Czech Republic|Support
Hartwig|Michelle Nealy|Macao|Jungler
Harty|Benny Burdick|Ecuador|Top
Hartz|Charlene Glenn|Philippines|Sub
Hartzel|Moises Dina|China|Top
Hartzell|William Hawk|Turkey|Top
Hartzke|Clara Clark|Kazakhstan|Sub
Hartzog|Emelda Henshaw|Thailand|Mid
Harumscarum|Dawn Bennett|Malta|Mid
Haruspex|James Colbert|United Kingdom|Top
Haruspicy|Todd Goodrow|United States|Mid
Harv|Andrew Williams|Afghanistan|Jungler
Harvard|Michael Prater|Malta|AD
Harve|Whitney Smith|Slovenia|Jungler
Harvell|Shannon Johnson|France|Top
Harvest|Paul Westcott|Belgium|Top
Harvester|Helen Sands|Italy|Sub
Harvestman|Micheal Hodgdon|Taiwan|Support
Harvey|Jackie Smith|China|Mid
Harveyharvie|Flor Bryant|Ecuador|Mid
Harville|Russell Larsen|Slovenia|Top
Harvin|Jeanette Royal|Italy|Jungler
Harvison|Jared Jones|United States|Jungler
Harwell|Willie Harris|Australia|Top
Harwill|Deann Grady|Greece|AD
Harwilll|Rosa Johnson|Spain|Support
Harwin|Javier Tweed|Italy|Sub
Harwood|Frank Twiford|China|Support
Has|Lisa Wells|Taiwan|AD
Hasa|Robert Marshall|Norway|Sub
Hasan|Sharon Rader|Poland|Sub
Hasbeen|Michelle Irizarry|Hungary|Sub
Hasdrubal|Eva Stone|Vietnam|Mid
Hasen|Yolanda Allen|United Kingdom|Top
Hash|Starr Williams|Thailand|Top
Hasheem|Mark Cook|Germany|AD
Hashim|Frank Hayes|Iraq|Jungler
Hashimoto|Eric Martinez|South Africa|Mid
Hashish|Juan Quelette|Russia|Support
Hashum|Alice Janczewski|Chile|Top
Hasid|Elton Evans|Turkey|Jungler
Hasidism|Johnnie Martinez|Lithuania|Jungler
Hasin|June Hopper|Slovenia|Mid
Haskel|Rosalba Mosley|Slovenia|Mid
Haskell|Shannon Lona|Malta|AD
Haskins|Adele Jones|Uruguay|Jungler
Haslam|James Gordon|Norway|Top
Haslet|Mark Pirman|Poland|Mid
Haslett|Ian Smith|Portugal|Top
Hasp|Wesley Windus|Belgium|Sub
Hass|Rebecca Davidson|Japan|Jungler
Hassan|John Nilsson|Hungary|AD
Hassanhassell|John Jackson|Hong Kong|Sub
Hasseman|Carl Evans|Estonia|Mid
Hassett|Donna Cavanaugh|Germany|Support
Hassi|Russell Costa|Uruguay|Mid
Hassiehassin|Jerry Jones|Czech Republic|Support
Hassle|Norma Colucci|South Korea|Sub
Hassler|Michael Early|Iceland|Sub
Hassock|Kyle Woodward|Malta|Support
Hasson|Adan Creel|Taiwan|AD
Hast|Jesse Cowman|Poland|Top
Hastate|Maria Negrete|Taiwan|Jungler
Haste|Dale Williams|Panama|Mid
Hasten|Addie Hanke|Russia|AD
Hastie|Beverly Evans|Brazil|Support
Hastings|Lyman Rivera|Colombia|Sub
Hasty|Joe Miller|Serbia|Sub
Haswell|William Emmons|Estonia|Mid
Hat|Lisa Campbell|Kazakhstan|Sub
Hatband|Elizabeth Green|Kazakhstan|Sub
Hatbox|Eric Ullrich|Hong Kong|Jungler
Hatch|Ana Biancardi|Lithuania|AD
Hatchel|Carol Shafer|Brazil|Sub
Hatcher|Kim Wallace|Mexico|Top
Hatchery|Walter Mayo|China|Jungler
Hatchet|Joseph Hill|Macao|Support
Hatchett|James Graves|Denmark|Sub
Hatching|William Beauchamp|Macao|AD
Hatchment|Saundra Tullar|Slovenia|Sub
Hatchway|Helen Simons|Colombia|Jungler
Hate|Suzanne West|Estonia|Top
Hateful|Charles Kloke|Armenia|Sub
Hatfield|Derek Battle|Kazakhstan|Support
Hath|James Parkhurst|Armenia|Support
Hathaway|Pamela Anglin|Turkey|Jungler
Hathcock|Robert Vickers|Czech Republic|Jungler
Hathor|Edgar Washington|Philippines|Top
Hathorn|Andrew Gardner|Chile|Mid
Hatley|Ruth June|Belgium|Jungler
Hatpin|Anna Eckhart|Hungary|AD
Hatred|Walter Clawson|Malta|Support
Hatshepsut|Courtney Kama|Poland|Top
Hatten|Dora Kinne|Taiwan|Jungler
Hatter|Douglas Handelman|Macao|Jungler
Hatteras|Charleen Hansen|Estonia|Sub
Hatti|Jasmine Shepard|Philippines|AD
Hattie|Anne Morris|China|Support
Hattiehatton|Paul Ferrer|Iceland|Sub
Hatty|Mildred Valenzuela|Colombia|Support
Hau|Amanda Thornton|South Korea|AD
Haubergeon|Sandra Fuentes|Russia|Jungler
Hauberk|Rosie Bellavance|Turkey|Mid
Hauck|Larry Ellis|Colombia|AD
Haug|Christine Torres|China|Mid
Hauge|Alesia Budd|Spain|Mid
Haugen|Derrick Page|Philippines|AD
Hauger|Dorothy Brown|Canada|Jungler
Haugh|Monica Hickman|France|Mid
Haughay|Christopher Davis|Germany|Mid
Haught|Aida Cox|Hong Kong|Support
Haughty|Joan Yetter|Ecuador|Jungler
Haukom|Justin Thong|Netherlands|Support
Haul|Lucia Lowe|Netherlands|Top
Haulage|Elizabeth Whitfield|Colombia|Mid
Hauler|Christie Mcdowell|Serbia|Sub
Haulm|Brett Lemons|Italy|Sub
Haun|William Beyett|Armenia|Support
Haunch|Donald Wright|Spain|Sub
Haunt|Billy Butler|Canada|Support
Haunted|Todd Casillas|Philippines|Support
Haunting|Melinda Sargent|Russia|AD
Haupt|James Stover|Malta|Top
Hauptmann|William Stewart|Iraq|Support
Hausa|Lena Deegan|Lithuania|Mid
Hauser|Michael Byrd|Iraq|Top
Hausfrau|Stephanie Delgado|Croatia|Support
Hausmann|Lois Allen|Poland|AD
Hausner|George Burke|Ecuador|AD
Haustellum|Helen Gonzalez|Spain|Mid
Haustorium|Steve Franklin|Poland|AD
Hautbois|Raul Hall|United Kingdom|Mid
Hautboy|Reggie Gower|Japan|Top
Hautegaronne|Betty Romine|Chile|Support
Hauteloire|Debra Girard|Mexico|Sub
Hautemarne|Brenda Hatley|Czech Republic|Jungler
Hautesalpes|Sharon Craig|Portugal|AD
Hautesavoie|William Summers|Poland|Mid
Hauteur|Joel Lane|Kazakhstan|Top
Hautevienne|Ross Ashley|Hungary|Mid
Hautrhin|James Schinkel|Norway|Mid
Havana|Louis Gomez|Turkey|AD
Havard|Jon Maldonado|Lithuania|Mid
Have|Stephen Mischler|Vietnam|Sub
Havelock|Wallace Chappell|Sweden|Jungler
Haveman|Daphine Dallmann|United Kingdom|Jungler
Haven|Laurie Johnson|Belgium|Jungler
Havener|Kemberly Taylor|Canada|Mid
Havenot|James Adams|Luxembourg|Sub
Havens|Rory Mcallister|China|Support
Haver|Shannon Alston|Canada|AD
Haversack|Brenda Gardner|Slovenia|Jungler
Haversine|Brady Crilly|Poland|Sub
Haviland|Rodney Goins|Greece|Jungler
Havildar|Sharon Minor|Colombia|Top
Havoc|Frank Lee|Costa Rica|Mid
Havre|Albert Trotter|Thailand|Mid
Havstad|Shirley Canon|Mexico|Sub
Haw|Tyler Jones|Norway|Jungler
Hawaii|William Busse|Luxembourg|Top
Hawaiian|Karen Holden|China|Mid
Hawes|Otis Milton|Finland|Support
Hawfinch|Evelyn Cline|Mexico|Support
Hawger|Virginia White|Lithuania|Jungler
Hawk|Charles Hopkins|Belgium|Top
Hawkbill|Anna Roebuck|China|AD
Hawken|Heather Godfrey|Hungary|Top
Hawker|Ramona Picard|Italy|Jungler
Hawkes|Robert Levings|Czech Republic|Jungler
Hawkeyed|Charles Gett|Netherlands|Mid
Hawkie|Michael Beasley|Poland|AD
Hawking|Joann Hochstatter|Slovenia|Jungler
Hawkins|Raeann Alex|France|Top
Hawkinson|Lena Martin|Chile|Top
Hawks|James Armstrong|Australia|Top
Hawkshaw|David Boggs|Vietnam|Sub
Hawkweed|Linda Betton|China|Sub
Hawley|Arturo Jones|Iceland|Mid
Hawn|Ryan Vincent|Italy|AD
Haworth|John Santarelli|Germany|AD
Haws|Travis Turner|Russia|Jungler
Hawse|Victoria Cohen|Spain|Mid
Hawsehole|Lawrence Gerber|Hong Kong|Sub
Hawsepiece|Jacqueline Newton|Armenia|Sub
Hawsepipe|Nancy Platt|Croatia|Sub
Hawser|Tina Bianco|Sweden|Mid
Hawserlaid|Mindy Adams|Costa Rica|Mid
Hawthorn|Barbara Sergio|Estonia|Top
Hawthorne|Ramon Patlan|United States|Top
Hax|Christopher Guerrero|Brazil|Mid
Hay|Gloria Priesmeyer|United States|Support
Haya|Connie Cumming|Vietnam|AD
Hayashi|Charles Bullinger|Russia|Support
Haycock|Emily Perry|Ukraine|AD
Haydeehayden|Ramona Collins|Armenia|Support
Hayden|Lisa Yu|Thailand|AD
Haydenhaydn|Alejandro Parson|Taiwan|Jungler
Haydon|Beulah Smith|Croatia|Support
Haye|Deanna Harrington|Hungary|Support
Hayes|Aaron Corrales|Turkey|Sub
Hayfield|Martha Boday|Italy|Top
Hayfork|Joan Gabrielson|Israel|Sub
Haygood|Edythe Mcannally|Luxembourg|AD
Hayley|Michael Schnell|Portugal|Mid
Hayleyhayloft|Edward Benningfield|Argentina|Jungler
Haymaker|Paul Bray|Canada|AD
Hayman|Shawn Roberts|Estonia|Top
Haymes|Edward Lee|Argentina|Sub
Haymo|Jean Brown|Mexico|Top
Haymow|Kenneth Chu|Chile|AD
Hayne|Joshua Carter|Japan|Top
Hayner|Scott Goodwin|Mexico|Top
Haynes|Dennis Greene|Thailand|Top
Haynie|John Gardner|Ukraine|Jungler
Haynor|William Chaddock|Uruguay|Sub
Hayott|Norman Zarek|Canada|Top
Hayrack|Annmarie Lacombe|Russia|Jungler
Hayrick|Jay Schwenck|Philippines|Mid
Hays|Rosario Canon|Czech Republic|AD
Hayse|Owen Desilets|United Kingdom|Mid
Hayseed|Kyle Mendoza|Finland|Top
Haystack|Barbara Villanueva|Colombia|AD
Hayton|Carolyn Dettinger|Macao|Jungler
Hayward|Marianne Ogawa|Afghanistan|Support
Haywire|Rufus Martinez|Ukraine|Support
Haywood|Scotty Salazar|South Korea|Sub
Haywoodhayyim|Richard Coller|Hungary|Support
Hazaki|Ann Garza|Italy|Mid
Hazan|Melanie Mcmillan|Germany|Sub
Hazard|Joseph Spencer|Malta|Mid
Hazardous|Jennifer Tibbetts|Ecuador|Top
Haze|Nicholas Reiher|Australia|Top
Hazeghi|Johnny Oniel|Serbia|Support
Hazel|Jon Balch|Afghanistan|Mid
Hazelhazelnut|David Story|Peru|Top
Hazelton|Ernest Williams|Luxembourg|Top
Hazelwood|Karen Torres|Indoensia|Jungler
Hazem|Eric Hall|United States|AD
Hazen|Harry Hoyle|Australia|AD
Hazing|Eric Muncy|Czech Republic|Sub
Hazlett|Victor Culbert|Singapore|Top
Hazlip|Jennifer John|China|Sub
Hazlitt|Earnest Boyd|Chile|AD
Hazy|Beverly Myers|Canada|Jungler
Hazzard|Melissa Gruwell|Vietnam|Top
Hb|Veronica Dennis|Hungary|AD
Hbeam|Allen Worden|Chile|Jungler
Hbomb|Jennie Wong|Spain|Top
He|Michell Falk|Argentina|Top
Head|Janet Howes|Costa Rica|Jungler
Headache|Sara Deleon|Canada|Mid
Headachy|Jessica Johnson|Denmark|Sub
Headband|Clara Considine|Norway|Support
Headboard|Arthur Haven|Belgium|Sub
Headcheese|Lieselotte Anthony|Uruguay|Jungler
Headcloth|Ryan Harry|Kazakhstan|Support
Headdress|Joshua Olden|Japan|Top
Headed|Ralph Vantassel|Israel|Sub
Header|Kenneth Millington|France|Jungler
Headfirst|Garth Anderson|Costa Rica|Top
Headforemost|Sandra Alvarez|Belgium|AD
Headgear|William Williams|Mexico|Mid
Heading|Dustin Troupe|France|Support
Headland|Maryann Lorentz|Mexico|Support
Headless|Victoria Mueller|Colombia|Jungler
Headley|Norma Fox|Turkey|Support
Headlight|Alta Breden|Argentina|AD
Headline|Rose Johnson|Brazil|Mid
Headliner|Christine Goodman|Belgium|Support
Headlock|Nathan Stanier|Panama|Support
Headlong|Venita Barber|Mexico|AD
Headman|Cody Estrada|Belgium|Support
Headmaster|Patrica Watson|Macao|AD
Headmistress|Martin Warner|Estonia|Support
Headmost|Tim Israels|Czech Republic|Support
Headon|Taylor Morehouse|Israel|Jungler
Headphone|Irene Jording|Hungary|Support
Headpiece|David Porter|Australia|Sub
Headpin|Laura Savino|Estonia|Jungler
Headquarters|Harley Rhoads|South Africa|Mid
Headrace|Warren Daley|Vietnam|Top
Headrail|George Chin|Malta|Top
Headreach|Shelby Shiver|Panama|Sub
Headrest|Tommy Brentley|Thailand|Sub
Headrick|James Goodman|Italy|Sub
Headroom|Robert Barfield|Portugal|Sub
Heads|Dawn Gillman|Lithuania|Support
Headsail|Vivian Lindstedt|Poland|Mid
Headset|Deborah Vanwagoner|Philippines|Support
Headship|Susan Watts|Peru|Top
Headsman|Phyllis Mcdowell|Poland|Sub
Headspring|Belinda Dumas|Hong Kong|Mid
Headstall|Jared Walton|Czech Republic|Sub
Headstand|Jeffrey Hall|Vietnam|Jungler
Headstock|David Rogers|Netherlands|Support
Headstone|Virgil Scaffidi|Italy|Sub
Headstream|Wade Cole|Lithuania|Top
Headstrong|Annie Mcfarlane|United Kingdom|Mid
Headwaiter|Jessica Franklin|Italy|Mid
Headward|Melvin Macias|Philippines|Mid
Headwards|Whitney Sinegal|Singapore|Mid
Headwater|Billy Smith|Ukraine|Top
Headwaters|Willie Caudillo|Portugal|Mid
Headway|Ashley Rath|Indoensia|Mid
Headwind|Elizabeth Yingling|Mexico|Mid
Headword|Sylvia Mccormick|Germany|Jungler
Headwork|Doreen Cantu|Indoensia|Jungler
Heady|Karen Decker|Macao|Mid
Heal|Paula Robinson|Mexico|AD
Healall|Kathleen Peterson|Colombia|AD
Heald|Cheryl Ellis|Netherlands|AD
Healey|Angela Wheatley|Germany|Support
Healing|Nathan Sandidge|Sweden|Sub
Healion|James Turner|Hong Kong|Support
Heall|Ana Stanley|Spain|Mid
Health|Joyce Childress|Armenia|Mid
Healthful|Margarita Heuck|Australia|Top
Healthy|Julie Hermosillo|Greece|Jungler
Healy|John Sylvester|Slovenia|Sub
Heaney|Michael Chai|South Africa|Support
Heap|Tina Chubbs|South Africa|Top
Heaps|Michael Garrett|Israel|Top
Hear|Heather Nelson|Portugal|Support
Heard|Ronald Crow|Croatia|Jungler
Hearing|Larry Herring|Luxembourg|Sub
Hearken|Jody Treece|Turkey|Sub
Hearn|Oscar Berry|China|AD
Hearne|Chad Brown|Russia|AD
Hearsay|David Fagan|South Africa|Top
Hearse|Jose Dickens|Malta|Jungler
Hearsh|Charles Meredith|Turkey|Support
Hearst|Dawn Mccoy|Brazil|Sub
Heart|Ricky Sagraves|Macao|Sub
Heartache|Billy Hirsch|Argentina|Support
Heartbeat|Barbara Beach|Peru|Jungler
Heartbreak|Thomas Hamm|Belgium|AD
Heartbreaker|Sharlene Mccloud|Kazakhstan|Sub
Heartbreaking|Dustin Graham|Iceland|Top
Heartbroken|Lacy White|South Korea|Jungler
Heartburn|Richard Thomas|Uruguay|Sub
Heartburning|Theodore Burgos|Sweden|Jungler
Hearten|Rex Blythe|Brazil|Jungler
Heartfelt|Dario Cameron|Ecuador|AD
Hearth|Mattie William|Denmark|Jungler
Hearthside|Melinda Barnett|Netherlands|Mid
Hearthstone|Amy Yost|Ecuador|Jungler
Heartily|David Smith|Peru|Jungler
Heartland|Paul Richardson|Costa Rica|Jungler
Heartless|June Mai|Kazakhstan|Support
Heartrending|Stacey Crane|United States|Top
Hearts|Thomas Gonzalez|Hungary|Mid
Heartsease|William James|Portugal|Support
Heartsick|James Carpenter|Greece|Support
Heartsome|Kenneth Cabello|Finland|Support
Heartstricken|Leona Cardinale|Norway|Sub
Heartstrings|Eugene Adkison|Taiwan|Top
Heartthrob|Stacy Burkey|France|Mid
Hearttoheart|Jenny Craig|Italy|Support
Heartwarming|Anna Robinson|Croatia|AD
Heartwhole|Hubert Gibbons|Macao|AD
Heartwood|Nancy Hollack|Armenia|Top
Heartworm|Michael Konowal|Hong Kong|Sub
Hearty|Brandy Sanchez|Spain|Jungler
Heat|Patricia Wilson|Finland|Mid
Heated|Joshua Jeter|Germany|Jungler
Heater|Gregorio Landry|Ecuador|Top
Heath|Helen Warner|Turkey|Support
Heathcote|Daniel Weideman|Afghanistan|Sub
Heathen|Patricia Simms|Poland|Top
Heathendom|Manuel Hamilton|Russia|Sub
Heathenish|Thomas Roan|United Kingdom|Sub
Heathenism|Andrea Webster|Indoensia|Top
Heathenize|William Leaton|Brazil|Mid
Heathenry|William Vonstein|Luxembourg|Jungler
Heather|Merle Godwin|Slovenia|AD
Heatherheatherly|Anita Davis|Hong Kong|Support
Heathheathberry|Jackie Ferraraccio|China|Mid
Heaton|George Hickey|Uruguay|Top
Heatstroke|Alicia Wilcox|Afghanistan|Mid
Heaume|Anthony Omalley|Costa Rica|Support
Heave|Michael Carter|South Africa|Jungler
Heaveho|James Godfrey|Denmark|AD
Heaven|Richard Robinson|Singapore|Support
Heavenly|Roslyn Weisenfluh|Peru|Support
Heavensent|Mary Williams|Ukraine|Jungler
Heavenward|Kristi Slane|Ukraine|Support
Heaver|Michael Mauldin|Ukraine|Support
Heaves|Rod Winfree|Denmark|AD
Heavierthanair|Christopher Thomas|Macao|Sub
Heavily|Leo Tristan|Singapore|AD
Heaviness|Corey Dupes|Italy|AD
Heaviside|Christina Johnson|Singapore|Support
Heavy|Richard Limon|Poland|Sub
Heavyarmed|Charles Mendez|Peru|Top
Heavyduty|Marie Myers|Estonia|Jungler
Heavyfooted|Linda Anderson|Ecuador|Support
Heavyhanded|Linda Miller|Luxembourg|Sub
Heavyhearted|Dionne Rivera|Iceland|AD
Heavyladen|Wanda Shell|Poland|Top
Heavyset|Veronica Ames|Turkey|Sub
Heavyweight|Frank Williams|Singapore|AD
Hebbe|Dorothy Postell|France|Support
Hebbel|Mathew Valentine|China|Sub
Hebdomad|Mary Mitchell|Lithuania|AD
Hebdomadal|Joyce Bailey|Netherlands|Jungler
Hebdomadary|Joseph Pullen|France|Sub
Hebe|John Hernandez|Chile|Mid
Hebel|Dana Person|Singapore|Top
Hebephrenia|Christopher Graves|United Kingdom|Mid
Heber|Matthew Mason|Peru|Mid
Hebert|William Tolentino|Finland|Sub
Hebetate|Mamie Ball|Netherlands|Sub
Hebetic|Nola Howard|South Korea|Sub
Hebetude|April Gamble|Spain|Mid
Hebner|Mary Tito|Iraq|Jungler
Hebraic|Tamika Aguilar|South Africa|AD
Hebraism|Helen Mcneill|Peru|Mid
Hebraist|Angelica Casson|Indoensia|Jungler
Hebraize|Gladys Pick|Uruguay|Mid
Hebrew|Hector Myrlie|Poland|Jungler
Hebrews|Sylvester Bracero|Serbia|Mid
Hebrides|Jill Fried|Luxembourg|Jungler
Hebron|Marie Tietjen|Portugal|Mid
Hecate|Cari Dickerson|Hong Kong|Support
Hecatomb|Kevin Barrera|Serbia|Mid
